"time_period","area","geographic_level","Cohort Group","Sustained Education","Sustained Apprenticeships","Sustained Employment","Not Recorded as a sustained destination","Unknown","Total"
201718,"England","COUNTRY","All other qualifications","12639","10969","19089","22017","10916","75630"
201718,"England","COUNTRY","Level 2","19645","12850","26024","14759","5979","79257"
201718,"England","COUNTRY","Level 3","217387","27086","89234","30770","14964","379441"
201718,"England","COUNTRY","Total","249671","50905","134347","67546","31859","534328"
201819,"England","COUNTRY","All other qualifications","12960","10231","19214","22674","9882","74961"
201819,"England","COUNTRY","Level 2","28801","14397","33098","19467","6474","102237"
201819,"England","COUNTRY","Level 3","203590","23864","81423","28188","13071","350136"
201819,"England","COUNTRY","Total","245351","48492","133735","70329","29427","527334"
201920,"England","COUNTRY","All other qualifications","14528","10242","20172","23964","9659","78565"
201920,"England","COUNTRY","Level 2","19662","11430","24542","16777","4951","77362"
201920,"England","COUNTRY","Level 3","212966","22105","84989","31516","13678","365254"
201920,"England","COUNTRY","Total","247156","43777","129703","72257","28288","521181"
202021,"England","COUNTRY","All other qualifications","20363","9961","19326","26615","8906","85171"
202021,"England","COUNTRY","Level 2","33328","9587","22247","19085","4782","89029"
202021,"England","COUNTRY","Level 3","227895","15239","73218","38061","14150","368563"
202021,"England","COUNTRY","Total","281586","34787","114791","83761","27838","542763"
201718,"County Durham","LADU","Total","1845","684","931","757","296","4513"
201718,"County Durham","LADU","Level 3","1539","366","561","273","143","2882"
201718,"County Durham","LADU","Level 2","183","184","219","186","45","817"
201718,"County Durham","LADU","All other qualifications","123","134","151","298","108","814"
201819,"County Durham","LADU","Total","1831","615","869","792","217","4324"
201819,"County Durham","LADU","Level 3","1394","323","456","208","72","2453"
201819,"County Durham","LADU","Level 2","320","168","267","274","55","1084"
201819,"County Durham","LADU","All other qualifications","117","124","146","310","90","787"
201920,"County Durham","LADU","Total","1755","610","833","831","208","4237"
201920,"County Durham","LADU","Level 3","1387","320","486","275","78","2546"
201920,"County Durham","LADU","Level 2","193","131","193","240","22","779"
201920,"County Durham","LADU","All other qualifications","175","159","154","316","108","912"
202021,"County Durham","LADU","Total","1992","407","839","859","186","4283"
202021,"County Durham","LADU","Level 3","1557","187","498","292","96","2630"
202021,"County Durham","LADU","Level 2","253","110","197","239","29","828"
202021,"County Durham","LADU","All other qualifications","182","110","144","328","61","825"
201718,"Darlington","LADU","Total","944","283","442","207","90","1966"
201718,"Darlington","LADU","Level 3","823","160","306","81","42","1412"
201718,"Darlington","LADU","Level 2","100","60","92","62","21","335"
201718,"Darlington","LADU","All other qualifications","21","63","44","64","27","219"
201819,"Darlington","LADU","Total","913","229","411","220","63","1836"
201819,"Darlington","LADU","Level 3","765","109","252","105","32","1263"
201819,"Darlington","LADU","Level 2","113","67","103","63","16","362"
201819,"Darlington","LADU","All other qualifications","35","53","56","52","15","211"
201920,"Darlington","LADU","Total","895","271","415","225","65","1871"
201920,"Darlington","LADU","Level 3","775","105","273","94","36","1283"
201920,"Darlington","LADU","Level 2","59","39","60","74","11","243"
201920,"Darlington","LADU","All other qualifications","61","127","82","57","18","345"
202021,"Darlington","LADU","Total","1084","241","402","296","50","2073"
202021,"Darlington","LADU","Level 3","947","73","241","126","28","1415"
202021,"Darlington","LADU","Level 2","96","29","70","50","5","250"
202021,"Darlington","LADU","All other qualifications","41","139","91","120","17","408"
201718,"Gateshead","LADU","Total","899","300","391","260","180","2030"
201718,"Gateshead","LADU","Level 3","806","153","231","128","59","1377"
201718,"Gateshead","LADU","Level 2","56","85","71","49","32","293"
201718,"Gateshead","LADU","All other qualifications","37","62","89","83","89","360"
201819,"Gateshead","LADU","Total","937","255","457","340","192","2181"
201819,"Gateshead","LADU","Level 3","774","114","239","107","50","1284"
201819,"Gateshead","LADU","Level 2","103","87","99","82","29","400"
201819,"Gateshead","LADU","All other qualifications","60","54","119","151","113","497"
201920,"Gateshead","LADU","Total","913","260","456","396","155","2180"
201920,"Gateshead","LADU","Level 3","787","129","255","153","48","1372"
201920,"Gateshead","LADU","Level 2","76","67","78","75","34","330"
201920,"Gateshead","LADU","All other qualifications","50","64","123","168","73","478"
202021,"Gateshead","LADU","Total","905","207","402","361","209","2084"
202021,"Gateshead","LADU","Level 3","747","73","204","151","59","1234"
202021,"Gateshead","LADU","Level 2","87","70","69","78","27","331"
202021,"Gateshead","LADU","All other qualifications","71","64","129","132","123","519"
201718,"Hartlepool","LADU","Total","560","201","180","179","75","1195"
201718,"Hartlepool","LADU","Level 3","469","134","123","92","37","855"
201718,"Hartlepool","LADU","Level 2","67","47","38","49","15","216"
201718,"Hartlepool","LADU","All other qualifications","24","20","19","38","23","124"
201819,"Hartlepool","LADU","Total","309","161","109","170","45","794"
201819,"Hartlepool","LADU","Level 3","182","47","40","39","11","319"
201819,"Hartlepool","LADU","Level 2","116","88","53","69","15","341"
201819,"Hartlepool","LADU","All other qualifications","11","26","16","62","19","134"
201920,"Hartlepool","LADU","Total","297","156","135","138","28","754"
201920,"Hartlepool","LADU","Level 3","225","79","64","42","11","421"
201920,"Hartlepool","LADU","Level 2","53","56","30","45","5","189"
201920,"Hartlepool","LADU","All other qualifications","19","21","41","51","12","144"
202021,"Hartlepool","LADU","Total","317","113","107","174","19","730"
202021,"Hartlepool","LADU","Level 3","198","52","65","51","7","373"
202021,"Hartlepool","LADU","Level 2","82","46","28","57","3","216"
202021,"Hartlepool","LADU","All other qualifications","37","15","14","66","9","141"
201718,"Middlesbrough","LADU","Total","1027","259","463","372","110","2231"
201718,"Middlesbrough","LADU","Level 3","889","120","275","152","37","1473"
201718,"Middlesbrough","LADU","Level 2","97","63","118","100","33","411"
201718,"Middlesbrough","LADU","All other qualifications","41","76","70","120","40","347"
201819,"Middlesbrough","LADU","Total","1155","303","537","483","112","2590"
201819,"Middlesbrough","LADU","Level 3","796","135","258","147","36","1372"
201819,"Middlesbrough","LADU","Level 2","309","97","207","197","26","836"
201819,"Middlesbrough","LADU","All other qualifications","50","71","72","139","50","382"
201920,"Middlesbrough","LADU","Total","1240","281","435","476","70","2502"
201920,"Middlesbrough","LADU","Level 3","949","116","238","159","25","1487"
201920,"Middlesbrough","LADU","Level 2","203","88","116","140","13","560"
201920,"Middlesbrough","LADU","All other qualifications","88","77","81","177","32","455"
202021,"Middlesbrough","LADU","Total","1160","221","384","487","88","2340"
202021,"Middlesbrough","LADU","Level 3","834","94","225","189","29","1371"
202021,"Middlesbrough","LADU","Level 2","228","60","94","127","18","527"
202021,"Middlesbrough","LADU","All other qualifications","98","67","65","171","41","442"
201718,"Newcastle upon Tyne","LADU","Total","2126","539","1145","995","391","5196"
201718,"Newcastle upon Tyne","LADU","Level 3","1851","268","662","301","116","3198"
201718,"Newcastle upon Tyne","LADU","Level 2","136","87","222","177","65","687"
201718,"Newcastle upon Tyne","LADU","All other qualifications","139","184","261","517","210","1311"
201819,"Newcastle upon Tyne","LADU","Total","2418","560","1309","1121","388","5796"
201819,"Newcastle upon Tyne","LADU","Level 3","1790","247","605","294","116","3052"
201819,"Newcastle upon Tyne","LADU","Level 2","359","149","400","333","77","1318"
201819,"Newcastle upon Tyne","LADU","All other qualifications","269","164","304","494","195","1426"
201920,"Newcastle upon Tyne","LADU","Total","2894","577","1398","1164","375","6408"
201920,"Newcastle upon Tyne","LADU","Level 3","2111","238","718","366","131","3564"
201920,"Newcastle upon Tyne","LADU","Level 2","486","184","361","340","75","1446"
201920,"Newcastle upon Tyne","LADU","All other qualifications","297","155","319","458","169","1398"
202021,"Newcastle upon Tyne","LADU","Total","3405","537","1254","1441","378","7015"
202021,"Newcastle upon Tyne","LADU","Level 3","2486","181","606","448","136","3857"
202021,"Newcastle upon Tyne","LADU","Level 2","563","177","341","367","88","1536"
202021,"Newcastle upon Tyne","LADU","All other qualifications","356","179","307","626","154","1622"
201718,"North Tyneside","LADU","Total","832","274","282","191","60","1639"
201718,"North Tyneside","LADU","Level 3","755","207","203","105","32","1302"
201718,"North Tyneside","LADU","Level 2","47","34","52","28","12","173"
201718,"North Tyneside","LADU","All other qualifications","30","33","27","58","16","164"
201819,"North Tyneside","LADU","Total","483","148","178","100","39","948"
201819,"North Tyneside","LADU","Level 3","477","77","135","43","18","750"
201819,"North Tyneside","LADU","Level 2","4","47","27","22","5","105"
201819,"North Tyneside","LADU","All other qualifications","2","24","16","35","16","93"
201920,"North Tyneside","LADU","Total","480","105","158","79","36","858"
201920,"North Tyneside","LADU","Level 3","471","75","137","46","21","750"
201920,"North Tyneside","LADU","Level 2","1","11","13","10","2","37"
201920,"North Tyneside","LADU","All other qualifications","8","19","8","23","13","71"
202021,"North Tyneside","LADU","Total","499","52","117","59","23","750"
202021,"North Tyneside","LADU","Level 3","485","39","102","47","14","687"
202021,"North Tyneside","LADU","Level 2","5","7","6","4","0","22"
202021,"North Tyneside","LADU","All other qualifications","9","6","9","8","9","41"
201718,"Northumberland","LADU","Total","1192","326","514","325","116","2473"
201718,"Northumberland","LADU","Level 3","1081","204","359","145","58","1847"
201718,"Northumberland","LADU","Level 2","66","76","101","78","14","335"
201718,"Northumberland","LADU","All other qualifications","45","46","54","102","44","291"
201819,"Northumberland","LADU","Total","1001","264","486","306","74","2131"
201819,"Northumberland","LADU","Level 3","867","154","341","118","30","1510"
201819,"Northumberland","LADU","Level 2","94","65","87","82","11","339"
201819,"Northumberland","LADU","All other qualifications","40","45","58","106","33","282"
201920,"Northumberland","LADU","Total","849","251","473","357","78","2008"
201920,"Northumberland","LADU","Level 3","812","159","333","173","44","1521"
201920,"Northumberland","LADU","Level 2","20","41","65","61","9","196"
201920,"Northumberland","LADU","All other qualifications","17","51","75","123","25","291"
202021,"Northumberland","LADU","Total","887","156","307","270","84","1704"
202021,"Northumberland","LADU","Level 3","854","75","241","148","44","1362"
202021,"Northumberland","LADU","Level 2","13","23","24","36","13","109"
202021,"Northumberland","LADU","All other qualifications","20","58","42","86","27","233"
201718,"Redcar and Cleveland","LADU","Total","583","128","169","160","50","1090"
201718,"Redcar and Cleveland","LADU","Level 3","554","80","136","78","34","882"
201718,"Redcar and Cleveland","LADU","Level 2","22","26","15","31","4","98"
201718,"Redcar and Cleveland","LADU","All other qualifications","7","22","18","51","12","110"
201819,"Redcar and Cleveland","LADU","Total","721","112","215","197","52","1297"
201819,"Redcar and Cleveland","LADU","Level 3","667","62","143","74","31","977"
201819,"Redcar and Cleveland","LADU","Level 2","37","24","41","61","8","171"
201819,"Redcar and Cleveland","LADU","All other qualifications","17","26","31","62","13","149"
201920,"Redcar and Cleveland","LADU","Total","561","105","129","128","28","951"
201920,"Redcar and Cleveland","LADU","Level 3","540","56","93","77","18","784"
201920,"Redcar and Cleveland","LADU","Level 2","10","26","10","11","5","62"
201920,"Redcar and Cleveland","LADU","All other qualifications","11","23","26","40","5","105"
202021,"Redcar and Cleveland","LADU","Total","627","74","140","132","39","1012"
202021,"Redcar and Cleveland","LADU","Level 3","607","37","122","82","22","870"
202021,"Redcar and Cleveland","LADU","Level 2","11","17","7","13","8","56"
202021,"Redcar and Cleveland","LADU","All other qualifications","9","20","11","37","9","86"
201718,"South Tyneside","LADU","Total","496","195","168","186","57","1102"
201718,"South Tyneside","LADU","Level 3","417","91","104","58","23","693"
201718,"South Tyneside","LADU","Level 2","39","26","33","39","10","147"
201718,"South Tyneside","LADU","All other qualifications","40","78","31","89","24","262"
201819,"South Tyneside","LADU","Total","709","305","256","264","71","1605"
201819,"South Tyneside","LADU","Level 3","496","146","139","80","22","883"
201819,"South Tyneside","LADU","Level 2","119","79","69","91","18","376"
201819,"South Tyneside","LADU","All other qualifications","94","80","48","93","31","346"
201920,"South Tyneside","LADU","Total","541","241","233","225","39","1279"
201920,"South Tyneside","LADU","Level 3","480","120","135","66","16","817"
201920,"South Tyneside","LADU","Level 2","30","74","60","55","11","230"
201920,"South Tyneside","LADU","All other qualifications","31","47","38","104","12","232"
202021,"South Tyneside","LADU","Total","863","246","275","372","67","1823"
202021,"South Tyneside","LADU","Level 3","600","101","131","114","22","968"
202021,"South Tyneside","LADU","Level 2","153","86","81","132","19","471"
202021,"South Tyneside","LADU","All other qualifications","110","59","63","126","26","384"
201718,"Stockton-on-Tees","LADU","Total","481","116","165","182","81","1025"
201718,"Stockton-on-Tees","LADU","Level 3","444","54","103","47","31","679"
201718,"Stockton-on-Tees","LADU","Level 2","16","22","25","26","7","96"
201718,"Stockton-on-Tees","LADU","All other qualifications","21","40","37","109","43","250"
201819,"Stockton-on-Tees","LADU","Total","486","107","211","225","59","1088"
201819,"Stockton-on-Tees","LADU","Level 3","400","56","104","53","19","632"
201819,"Stockton-on-Tees","LADU","Level 2","64","27","55","59","8","213"
201819,"Stockton-on-Tees","LADU","All other qualifications","22","24","52","113","32","243"
201920,"Stockton-on-Tees","LADU","Total","512","81","165","221","39","1018"
201920,"Stockton-on-Tees","LADU","Level 3","441","41","111","70","18","681"
201920,"Stockton-on-Tees","LADU","Level 2","36","10","14","42","3","105"
201920,"Stockton-on-Tees","LADU","All other qualifications","35","30","40","109","18","232"
202021,"Stockton-on-Tees","LADU","Total","704","119","256","339","53","1471"
202021,"Stockton-on-Tees","LADU","Level 3","549","60","152","115","22","898"
202021,"Stockton-on-Tees","LADU","Level 2","89","31","48","82","4","254"
202021,"Stockton-on-Tees","LADU","All other qualifications","66","28","56","142","27","319"
201718,"Sunderland","LADU","Total","822","366","396","307","96","1987"
201718,"Sunderland","LADU","Level 3","778","161","239","118","40","1336"
201718,"Sunderland","LADU","Level 2","27","56","89","76","16","264"
201718,"Sunderland","LADU","All other qualifications","17","149","68","113","40","387"
201819,"Sunderland","LADU","Total","1069","355","518","463","87","2492"
201819,"Sunderland","LADU","Level 3","910","148","252","145","30","1485"
201819,"Sunderland","LADU","Level 2","128","83","192","188","22","613"
201819,"Sunderland","LADU","All other qualifications","31","124","74","130","35","394"
201920,"Sunderland","LADU","Total","1210","324","474","484","95","2587"
201920,"Sunderland","LADU","Level 3","1119","146","312","203","36","1816"
201920,"Sunderland","LADU","Level 2","55","93","97","134","17","396"
201920,"Sunderland","LADU","All other qualifications","36","85","65","147","42","375"
202021,"Sunderland","LADU","Total","1646","233","492","656","125","3152"
202021,"Sunderland","LADU","Level 3","1269","96","286","265","59","1975"
202021,"Sunderland","LADU","Level 2","267","65","131","177","23","663"
202021,"Sunderland","LADU","All other qualifications","110","72","75","214","43","514"
201718,"Allerdale","LADU","Total","426","222","226","117","47","1038"
201718,"Allerdale","LADU","Level 3","357","125","133","27","19","661"
201718,"Allerdale","LADU","Level 2","52","60","60","52","10","234"
201718,"Allerdale","LADU","All other qualifications","17","37","33","38","18","143"
201819,"Allerdale","LADU","Total","404","170","206","116","28","924"
201819,"Allerdale","LADU","Level 3","332","75","105","29","11","552"
201819,"Allerdale","LADU","Level 2","53","65","69","31","7","225"
201819,"Allerdale","LADU","All other qualifications","19","30","32","56","10","147"
201920,"Allerdale","LADU","Total","398","232","205","145","52","1032"
201920,"Allerdale","LADU","Level 3","328","121","123","54","21","647"
201920,"Allerdale","LADU","Level 2","43","71","57","45","13","229"
201920,"Allerdale","LADU","All other qualifications","27","40","25","46","18","156"
202021,"Allerdale","LADU","Total","384","123","224","154","35","920"
202021,"Allerdale","LADU","Level 3","323","64","136","66","15","604"
202021,"Allerdale","LADU","Level 2","39","38","53","42","7","179"
202021,"Allerdale","LADU","All other qualifications","22","21","35","46","13","137"
201718,"Barrow-in-Furness","LADU","Total","183","240","137","96","38","694"
201718,"Barrow-in-Furness","LADU","Level 3","141","110","69","31","13","364"
201718,"Barrow-in-Furness","LADU","Level 2","34","105","38","30","12","219"
201718,"Barrow-in-Furness","LADU","All other qualifications","8","25","30","35","13","111"
201819,"Barrow-in-Furness","LADU","Total","216","272","197","125","29","839"
201819,"Barrow-in-Furness","LADU","Level 3","119","121","81","27","8","356"
201819,"Barrow-in-Furness","LADU","Level 2","75","112","79","49","8","323"
201819,"Barrow-in-Furness","LADU","All other qualifications","22","39","37","49","13","160"
201920,"Barrow-in-Furness","LADU","Total","205","211","165","116","32","729"
201920,"Barrow-in-Furness","LADU","Level 3","121","95","59","25","16","316"
201920,"Barrow-in-Furness","LADU","Level 2","57","77","56","30","7","227"
201920,"Barrow-in-Furness","LADU","All other qualifications","27","39","50","61","9","186"
202021,"Barrow-in-Furness","LADU","Total","208","199","121","123","17","668"
202021,"Barrow-in-Furness","LADU","Level 3","136","76","59","33","5","309"
202021,"Barrow-in-Furness","LADU","Level 2","46","86","28","23","3","186"
202021,"Barrow-in-Furness","LADU","All other qualifications","26","37","34","67","9","173"
201718,"Blackburn with Darwen","LADU","Total","1172","221","355","287","115","2150"
201718,"Blackburn with Darwen","LADU","Level 3","925","104","210","117","53","1409"
201718,"Blackburn with Darwen","LADU","Level 2","130","46","78","45","17","316"
201718,"Blackburn with Darwen","LADU","All other qualifications","117","71","67","125","45","425"
201819,"Blackburn with Darwen","LADU","Total","1130","185","370","300","107","2092"
201819,"Blackburn with Darwen","LADU","Level 3","797","80","185","99","30","1191"
201819,"Blackburn with Darwen","LADU","Level 2","216","67","120","92","19","514"
201819,"Blackburn with Darwen","LADU","All other qualifications","117","38","65","109","58","387"
201920,"Blackburn with Darwen","LADU","Total","914","177","364","329","110","1894"
201920,"Blackburn with Darwen","LADU","Level 3","790","71","210","128","47","1246"
201920,"Blackburn with Darwen","LADU","Level 2","68","52","78","68","16","282"
201920,"Blackburn with Darwen","LADU","All other qualifications","56","54","76","133","47","366"
202021,"Blackburn with Darwen","LADU","Total","1157","158","363","426","117","2221"
202021,"Blackburn with Darwen","LADU","Level 3","836","60","225","178","64","1363"
202021,"Blackburn with Darwen","LADU","Level 2","215","58","75","112","20","480"
202021,"Blackburn with Darwen","LADU","All other qualifications","106","40","63","136","33","378"
201718,"Blackpool","LADU","Total","948","186","523","390","114","2161"
201718,"Blackpool","LADU","Level 3","845","102","376","180","48","1551"
201718,"Blackpool","LADU","Level 2","53","29","102","86","30","300"
201718,"Blackpool","LADU","All other qualifications","50","55","45","124","36","310"
201819,"Blackpool","LADU","Total","882","224","584","397","99","2186"
201819,"Blackpool","LADU","Level 3","742","111","373","146","39","1411"
201819,"Blackpool","LADU","Level 2","99","64","144","134","29","470"
201819,"Blackpool","LADU","All other qualifications","41","49","67","117","31","305"
201920,"Blackpool","LADU","Total","882","192","588","434","108","2204"
201920,"Blackpool","LADU","Level 3","797","81","398","154","43","1473"
201920,"Blackpool","LADU","Level 2","42","49","105","120","21","337"
201920,"Blackpool","LADU","All other qualifications","43","62","85","160","44","394"
202021,"Blackpool","LADU","Total","1174","188","580","517","112","2571"
202021,"Blackpool","LADU","Level 3","906","80","392","222","56","1656"
202021,"Blackpool","LADU","Level 2","162","61","92","133","27","475"
202021,"Blackpool","LADU","All other qualifications","106","47","96","162","29","440"
201718,"Bolton","LADU","Total","1024","245","507","397","165","2338"
201718,"Bolton","LADU","Level 3","835","117","294","143","82","1471"
201718,"Bolton","LADU","Level 2","81","68","104","90","30","373"
201718,"Bolton","LADU","All other qualifications","108","60","109","164","53","494"
201819,"Bolton","LADU","Total","1172","191","466","378","167","2374"
201819,"Bolton","LADU","Level 3","791","79","226","109","57","1262"
201819,"Bolton","LADU","Level 2","254","56","152","112","33","607"
201819,"Bolton","LADU","All other qualifications","127","56","88","157","77","505"
201920,"Bolton","LADU","Total","1150","194","478","395","126","2343"
201920,"Bolton","LADU","Level 3","896","92","275","147","48","1458"
201920,"Bolton","LADU","Level 2","116","51","97","84","17","365"
201920,"Bolton","LADU","All other qualifications","138","51","106","164","61","520"
202021,"Bolton","LADU","Total","1247","148","404","431","140","2370"
202021,"Bolton","LADU","Level 3","894","59","218","158","54","1383"
202021,"Bolton","LADU","Level 2","204","37","95","114","26","476"
202021,"Bolton","LADU","All other qualifications","149","52","91","159","60","511"
201718,"Burnley","LADU","Total","461","171","262","148","59","1101"
201718,"Burnley","LADU","Level 3","364","107","170","59","23","723"
201718,"Burnley","LADU","Level 2","59","32","59","30","9","189"
201718,"Burnley","LADU","All other qualifications","38","32","33","59","27","189"
201819,"Burnley","LADU","Total","394","159","231","172","71","1027"
201819,"Burnley","LADU","Level 3","327","71","127","40","25","590"
201819,"Burnley","LADU","Level 2","47","47","66","50","15","225"
201819,"Burnley","LADU","All other qualifications","20","41","38","82","31","212"
201920,"Burnley","LADU","Total","482","199","271","199","77","1228"
201920,"Burnley","LADU","Level 3","392","123","175","70","31","791"
201920,"Burnley","LADU","Level 2","47","36","44","47","8","182"
201920,"Burnley","LADU","All other qualifications","43","40","52","82","38","255"
202021,"Burnley","LADU","Total","726","248","298","297","57","1626"
202021,"Burnley","LADU","Level 3","476","145","170","108","22","921"
202021,"Burnley","LADU","Level 2","157","50","62","67","6","342"
202021,"Burnley","LADU","All other qualifications","93","53","66","122","29","363"
201718,"Bury","LADU","Total","1322","309","777","356","167","2931"
201718,"Bury","LADU","Level 3","1189","181","524","171","95","2160"
201718,"Bury","LADU","Level 2","98","65","169","86","32","450"
201718,"Bury","LADU","All other qualifications","35","63","84","99","40","321"
201819,"Bury","LADU","Total","1389","322","771","440","160","3082"
201819,"Bury","LADU","Level 3","1150","159","469","163","76","2017"
201819,"Bury","LADU","Level 2","187","98","213","133","40","671"
201819,"Bury","LADU","All other qualifications","52","65","89","144","44","394"
201920,"Bury","LADU","Total","1329","260","704","450","153","2896"
201920,"Bury","LADU","Level 3","1191","157","491","232","79","2150"
201920,"Bury","LADU","Level 2","87","58","121","97","25","388"
201920,"Bury","LADU","All other qualifications","51","45","92","121","49","358"
202021,"Bury","LADU","Total","1638","177","567","501","138","3021"
202021,"Bury","LADU","Level 3","1225","83","381","241","81","2011"
202021,"Bury","LADU","Level 2","315","43","118","114","21","611"
202021,"Bury","LADU","All other qualifications","98","51","68","146","36","399"
201718,"Carlisle","LADU","Total","399","169","312","118","43","1041"
201718,"Carlisle","LADU","Level 3","344","82","150","45","16","637"
201718,"Carlisle","LADU","Level 2","30","56","81","32","13","212"
201718,"Carlisle","LADU","All other qualifications","25","31","81","41","14","192"
201819,"Carlisle","LADU","Total","214","105","162","80","33","594"
201819,"Carlisle","LADU","Level 3","209","38","100","28","9","384"
201819,"Carlisle","LADU","Level 2","1","33","30","16","10","90"
201819,"Carlisle","LADU","All other qualifications","4","34","32","36","14","120"
201920,"Carlisle","LADU","Total","240","116","129","55","31","571"
201920,"Carlisle","LADU","Level 3","235","43","90","24","18","410"
201920,"Carlisle","LADU","Level 2","2","24","15","8","8","57"
201920,"Carlisle","LADU","All other qualifications","3","49","24","23","5","104"
202021,"Carlisle","LADU","Total","221","24","66","20","10","341"
202021,"Carlisle","LADU","Level 3","220","17","59","18","7","321"
202021,"Carlisle","LADU","Level 2","0","0","0","1","2","3"
202021,"Carlisle","LADU","All other qualifications","1","7","7","1","1","17"
201718,"Cheshire East","LADU","Total","1850","496","1189","435","211","4181"
201718,"Cheshire East","LADU","Level 3","1608","299","839","236","123","3105"
201718,"Cheshire East","LADU","Level 2","132","116","214","86","46","594"
201718,"Cheshire East","LADU","All other qualifications","110","81","136","113","42","482"
201819,"Cheshire East","LADU","Total","2219","573","1419","572","234","5017"
201819,"Cheshire East","LADU","Level 3","1778","316","833","229","107","3263"
201819,"Cheshire East","LADU","Level 2","339","167","423","198","71","1198"
201819,"Cheshire East","LADU","All other qualifications","102","90","163","145","56","556"
201920,"Cheshire East","LADU","Total","2109","486","1411","596","241","4843"
201920,"Cheshire East","LADU","Level 3","1774","266","925","259","134","3358"
201920,"Cheshire East","LADU","Level 2","206","111","299","158","53","827"
201920,"Cheshire East","LADU","All other qualifications","129","109","187","179","54","658"
202021,"Cheshire East","LADU","Total","2504","413","1336","725","217","5195"
202021,"Cheshire East","LADU","Level 3","1947","189","876","341","117","3470"
202021,"Cheshire East","LADU","Level 2","331","118","283","173","48","953"
202021,"Cheshire East","LADU","All other qualifications","226","106","177","211","52","772"
201718,"Cheshire West and Chester","LADU","Total","1843","324","947","364","150","3628"
201718,"Cheshire West and Chester","LADU","Level 3","1694","184","687","184","76","2825"
201718,"Cheshire West and Chester","LADU","Level 2","106","70","150","58","24","408"
201718,"Cheshire West and Chester","LADU","All other qualifications","43","70","110","122","50","395"
201819,"Cheshire West and Chester","LADU","Total","1297","233","561","221","85","2397"
201819,"Cheshire West and Chester","LADU","Level 3","1277","154","443","133","51","2058"
201819,"Cheshire West and Chester","LADU","Level 2","12","28","55","24","10","129"
201819,"Cheshire West and Chester","LADU","All other qualifications","8","51","63","64","24","210"
201920,"Cheshire West and Chester","LADU","Total","1278","196","547","184","80","2285"
201920,"Cheshire West and Chester","LADU","Level 3","1265","135","455","113","55","2023"
201920,"Cheshire West and Chester","LADU","Level 2","6","24","38","18","6","92"
201920,"Cheshire West and Chester","LADU","All other qualifications","7","37","54","53","19","170"
202021,"Cheshire West and Chester","LADU","Total","1274","103","381","156","75","1989"
202021,"Cheshire West and Chester","LADU","Level 3","1261","84","351","137","58","1891"
202021,"Cheshire West and Chester","LADU","Level 2","4","3","11","1","6","25"
202021,"Cheshire West and Chester","LADU","All other qualifications","9","16","19","18","11","73"
201718,"Chorley","LADU","Total","72","21","20","10","4","127"
201718,"Chorley","LADU","Level 3","72","19","17","8","4","120"
201718,"Chorley","LADU","Level 2","0","1","1","1","0","3"
201718,"Chorley","LADU","All other qualifications","0","1","2","1","0","4"
201819,"Chorley","LADU","Total","62","17","30","6","1","116"
201819,"Chorley","LADU","Level 3","56","13","25","5","1","100"
201819,"Chorley","LADU","Level 2","4","2","4","0","0","10"
201819,"Chorley","LADU","All other qualifications","2","2","1","1","0","6"
201920,"Chorley","LADU","Total","58","11","20","9","5","103"
201920,"Chorley","LADU","Level 3","53","10","18","7","5","93"
201920,"Chorley","LADU","Level 2","0","0","2","1","0","3"
201920,"Chorley","LADU","All other qualifications","5","1","0","1","0","7"
202021,"Chorley","LADU","Total","60","9","29","16","3","117"
202021,"Chorley","LADU","Level 3","60","5","26","12","2","105"
202021,"Chorley","LADU","Level 2","0","0","2","2","0","4"
202021,"Chorley","LADU","All other qualifications","0","4","1","2","1","8"
201718,"Copeland","LADU","Total","121","71","33","25","11","261"
201718,"Copeland","LADU","Level 3","119","66","29","18","10","242"
201718,"Copeland","LADU","Level 2","2","1","4","4","1","12"
201718,"Copeland","LADU","All other qualifications","0","4","0","3","0","7"
201819,"Copeland","LADU","Total","102","67","29","23","10","231"
201819,"Copeland","LADU","Level 3","101","63","25","16","6","211"
201819,"Copeland","LADU","Level 2","1","3","1","4","0","9"
201819,"Copeland","LADU","All other qualifications","0","1","3","3","4","11"
201920,"Copeland","LADU","Total","97","51","33","16","2","199"
201920,"Copeland","LADU","Level 3","95","44","28","14","0","181"
201920,"Copeland","LADU","Level 2","2","6","5","2","0","15"
201920,"Copeland","LADU","All other qualifications","0","1","0","0","2","3"
202021,"Copeland","LADU","Total","92","44","34","23","7","200"
202021,"Copeland","LADU","Level 3","92","44","34","22","7","199"
202021,"Copeland","LADU","All other qualifications","0","0","0","1","0","1"
201718,"Eden","LADU","Total","179","22","65","22","10","298"
201718,"Eden","LADU","Level 3","175","14","57","19","5","270"
201718,"Eden","LADU","Level 2","2","6","3","2","3","16"
201718,"Eden","LADU","All other qualifications","2","2","5","1","2","12"
201819,"Eden","LADU","Total","208","25","68","18","8","327"
201819,"Eden","LADU","Level 3","206","20","56","14","6","302"
201819,"Eden","LADU","Level 2","1","1","8","3","2","15"
201819,"Eden","LADU","All other qualifications","1","4","4","1","0","10"
201920,"Eden","LADU","Total","174","18","62","13","6","273"
201920,"Eden","LADU","Level 3","166","15","54","10","6","251"
201920,"Eden","LADU","Level 2","2","1","4","0","0","7"
201920,"Eden","LADU","All other qualifications","6","2","4","3","0","15"
202021,"Eden","LADU","Total","176","15","50","22","9","272"
202021,"Eden","LADU","Level 3","170","8","44","17","6","245"
202021,"Eden","LADU","Level 2","0","3","3","1","2","9"
202021,"Eden","LADU","All other qualifications","6","4","3","4","1","18"
201718,"Fylde","LADU","Total","61","18","26","13","8","126"
201718,"Fylde","LADU","Level 3","57","16","20","8","5","106"
201718,"Fylde","LADU","Level 2","3","2","2","3","1","11"
201718,"Fylde","LADU","All other qualifications","1","0","4","2","2","9"
201819,"Fylde","LADU","Total","48","6","25","8","5","92"
201819,"Fylde","LADU","Level 3","48","5","21","7","4","85"
201819,"Fylde","LADU","Level 2","0","1","2","1","0","4"
201819,"Fylde","LADU","All other qualifications","0","0","2","0","1","3"
201920,"Fylde","LADU","Total","17","8","9","7","5","46"
201920,"Fylde","LADU","Level 3","17","4","5","2","2","30"
201920,"Fylde","LADU","Level 2","0","0","2","0","0","2"
201920,"Fylde","LADU","All other qualifications","0","4","2","5","3","14"
202021,"Fylde","LADU","Total","0","3","2","2","2","9"
202021,"Fylde","LADU","Level 3","0","0","0","1","0","1"
202021,"Fylde","LADU","Level 2","0","0","1","0","2","3"
202021,"Fylde","LADU","All other qualifications","0","3","1","1","0","5"
201718,"Halton","LADU","Total","838","181","525","252","94","1890"
201718,"Halton","LADU","Level 3","561","71","324","89","38","1083"
201718,"Halton","LADU","Level 2","201","66","127","67","21","482"
201718,"Halton","LADU","All other qualifications","76","44","74","96","35","325"
201819,"Halton","LADU","Total","638","150","407","239","74","1508"
201819,"Halton","LADU","Level 3","459","64","217","73","19","832"
201819,"Halton","LADU","Level 2","152","44","132","80","23","431"
201819,"Halton","LADU","All other qualifications","27","42","58","86","32","245"
201920,"Halton","LADU","Total","763","177","475","342","83","1840"
201920,"Halton","LADU","Level 3","527","83","255","111","25","1001"
201920,"Halton","LADU","Level 2","171","56","135","88","18","468"
201920,"Halton","LADU","All other qualifications","65","38","85","143","40","371"
202021,"Halton","LADU","Total","774","142","379","345","71","1711"
202021,"Halton","LADU","Level 3","489","47","202","121","25","884"
202021,"Halton","LADU","Level 2","205","60","94","71","12","442"
202021,"Halton","LADU","All other qualifications","80","35","83","153","34","385"
201718,"Hyndburn","LADU","Total","268","85","130","118","49","650"
201718,"Hyndburn","LADU","Level 3","188","26","64","31","20","329"
201718,"Hyndburn","LADU","Level 2","38","37","29","24","8","136"
201718,"Hyndburn","LADU","All other qualifications","42","22","37","63","21","185"
201819,"Hyndburn","LADU","Total","252","71","119","105","36","583"
201819,"Hyndburn","LADU","Level 3","178","26","56","20","8","288"
201819,"Hyndburn","LADU","Level 2","28","22","34","18","8","110"
201819,"Hyndburn","LADU","All other qualifications","46","23","29","67","20","185"
201920,"Hyndburn","LADU","Total","202","39","88","110","31","470"
201920,"Hyndburn","LADU","Level 3","176","12","51","26","7","272"
201920,"Hyndburn","LADU","Level 2","8","8","18","23","4","61"
201920,"Hyndburn","LADU","All other qualifications","18","19","19","61","20","137"
202021,"Hyndburn","LADU","Total","179","25","52","67","17","340"
202021,"Hyndburn","LADU","Level 3","164","6","28","23","8","229"
202021,"Hyndburn","LADU","Level 2","3","8","2","3","1","17"
202021,"Hyndburn","LADU","All other qualifications","12","11","22","41","8","94"
201718,"Knowsley","LADU","Total","123","59","137","129","39","487"
201718,"Knowsley","LADU","Level 3","85","15","66","39","19","224"
201718,"Knowsley","LADU","Level 2","25","31","51","39","6","152"
201718,"Knowsley","LADU","All other qualifications","13","13","20","51","14","111"
201819,"Knowsley","LADU","Total","147","61","121","121","36","486"
201819,"Knowsley","LADU","Level 3","57","13","34","17","6","127"
201819,"Knowsley","LADU","Level 2","78","30","55","53","17","233"
201819,"Knowsley","LADU","All other qualifications","12","18","32","51","13","126"
201920,"Knowsley","LADU","Total","11","27","46","72","25","181"
201920,"Knowsley","LADU","Level 3","11","6","10","10","2","39"
201920,"Knowsley","LADU","Level 2","0","7","19","18","4","48"
201920,"Knowsley","LADU","All other qualifications","0","14","17","44","19","94"
202021,"Knowsley","LADU","Total","45","15","38","38","14","150"
202021,"Knowsley","LADU","Level 3","23","1","11","7","0","42"
202021,"Knowsley","LADU","Level 2","14","8","8","9","2","41"
202021,"Knowsley","LADU","All other qualifications","8","6","19","22","12","67"
201718,"Lancaster","LADU","Total","592","144","383","197","107","1423"
201718,"Lancaster","LADU","Level 3","556","84","259","80","50","1029"
201718,"Lancaster","LADU","Level 2","30","32","86","55","23","226"
201718,"Lancaster","LADU","All other qualifications","6","28","38","62","34","168"
201819,"Lancaster","LADU","Total","594","158","363","208","78","1401"
201819,"Lancaster","LADU","Level 3","482","55","189","53","30","809"
201819,"Lancaster","LADU","Level 2","87","61","121","80","25","374"
201819,"Lancaster","LADU","All other qualifications","25","42","53","75","23","218"
201920,"Lancaster","LADU","Total","550","144","275","194","71","1234"
201920,"Lancaster","LADU","Level 3","472","61","181","72","36","822"
201920,"Lancaster","LADU","Level 2","47","34","58","52","10","201"
201920,"Lancaster","LADU","All other qualifications","31","49","36","70","25","211"
202021,"Lancaster","LADU","Total","528","99","277","207","66","1177"
202021,"Lancaster","LADU","Level 3","425","32","169","78","39","743"
202021,"Lancaster","LADU","Level 2","69","31","77","54","7","238"
202021,"Lancaster","LADU","All other qualifications","34","36","31","75","20","196"
201718,"Liverpool","LADU","Total","2270","356","832","528","252","4238"
201718,"Liverpool","LADU","Level 3","2075","215","578","272","136","3276"
201718,"Liverpool","LADU","Level 2","123","72","172","124","45","536"
201718,"Liverpool","LADU","All other qualifications","72","69","82","132","71","426"
201819,"Liverpool","LADU","Total","2289","315","842","578","183","4207"
201819,"Liverpool","LADU","Level 3","1939","158","559","299","99","3054"
201819,"Liverpool","LADU","Level 2","262","94","185","165","36","742"
201819,"Liverpool","LADU","All other qualifications","88","63","98","114","48","411"
201920,"Liverpool","LADU","Total","2139","307","807","566","213","4032"
201920,"Liverpool","LADU","Level 3","1887","153","536","296","118","2990"
201920,"Liverpool","LADU","Level 2","152","86","167","143","47","595"
201920,"Liverpool","LADU","All other qualifications","100","68","104","127","48","447"
202021,"Liverpool","LADU","Total","2463","227","675","723","181","4269"
202021,"Liverpool","LADU","Level 3","2152","95","426","362","98","3133"
202021,"Liverpool","LADU","Level 2","195","60","151","181","35","622"
202021,"Liverpool","LADU","All other qualifications","116","72","98","180","48","514"
201718,"Manchester","LADU","Total","2795","336","1044","728","466","5369"
201718,"Manchester","LADU","Level 3","2456","167","668","319","204","3814"
201718,"Manchester","LADU","Level 2","168","67","214","152","82","683"
201718,"Manchester","LADU","All other qualifications","171","102","162","257","180","872"
201819,"Manchester","LADU","Total","3126","345","1141","883","434","5929"
201819,"Manchester","LADU","Level 3","2523","177","699","340","213","3952"
201819,"Manchester","LADU","Level 2","370","71","258","238","79","1016"
201819,"Manchester","LADU","All other qualifications","233","97","184","305","142","961"
201920,"Manchester","LADU","Total","3097","279","1075","863","429","5743"
201920,"Manchester","LADU","Level 3","2671","150","734","387","194","4136"
201920,"Manchester","LADU","Level 2","236","43","131","162","61","633"
201920,"Manchester","LADU","All other qualifications","190","86","210","314","174","974"
202021,"Manchester","LADU","Total","3874","172","905","1136","417","6504"
202021,"Manchester","LADU","Level 3","2788","71","576","494","219","4148"
202021,"Manchester","LADU","Level 2","601","34","129","190","37","991"
202021,"Manchester","LADU","All other qualifications","485","67","200","452","161","1365"
201718,"Oldham","LADU","Total","1269","220","515","367","174","2545"
201718,"Oldham","LADU","Level 3","1115","106","304","153","60","1738"
201718,"Oldham","LADU","Level 2","101","62","113","78","32","386"
201718,"Oldham","LADU","All other qualifications","53","52","98","136","82","421"
201819,"Oldham","LADU","Total","1273","232","485","374","113","2477"
201819,"Oldham","LADU","Level 3","1032","105","236","117","46","1536"
201819,"Oldham","LADU","Level 2","179","81","164","146","26","596"
201819,"Oldham","LADU","All other qualifications","62","46","85","111","41","345"
201920,"Oldham","LADU","Total","1322","194","438","409","125","2488"
201920,"Oldham","LADU","Level 3","1166","102","289","184","59","1800"
201920,"Oldham","LADU","Level 2","89","54","86","100","23","352"
201920,"Oldham","LADU","All other qualifications","67","38","63","125","43","336"
202021,"Oldham","LADU","Total","1649","181","456","573","164","3023"
202021,"Oldham","LADU","Level 3","1299","78","257","223","77","1934"
202021,"Oldham","LADU","Level 2","223","59","118","153","22","575"
202021,"Oldham","LADU","All other qualifications","127","44","81","197","65","514"
201718,"Pendle","LADU","Total","427","85","168","118","46","844"
201718,"Pendle","LADU","Level 3","348","32","88","41","16","525"
201718,"Pendle","LADU","Level 2","45","35","43","28","7","158"
201718,"Pendle","LADU","All other qualifications","34","18","37","49","23","161"
201819,"Pendle","LADU","Total","385","74","144","113","43","759"
201819,"Pendle","LADU","Level 3","295","36","77","27","9","444"
201819,"Pendle","LADU","Level 2","50","25","40","32","11","158"
201819,"Pendle","LADU","All other qualifications","40","13","27","54","23","157"
201920,"Pendle","LADU","Total","510","84","193","137","34","958"
201920,"Pendle","LADU","Level 3","453","38","91","48","13","643"
201920,"Pendle","LADU","Level 2","23","22","58","36","5","144"
201920,"Pendle","LADU","All other qualifications","34","24","44","53","16","171"
202021,"Pendle","LADU","Total","628","89","200","220","55","1192"
202021,"Pendle","LADU","Level 3","422","36","92","76","17","643"
202021,"Pendle","LADU","Level 2","125","22","53","46","16","262"
202021,"Pendle","LADU","All other qualifications","81","31","55","98","22","287"
201718,"Preston","LADU","Total","1316","266","536","315","138","2571"
201718,"Preston","LADU","Level 3","1158","132","377","117","62","1846"
201718,"Preston","LADU","Level 2","91","72","86","61","20","330"
201718,"Preston","LADU","All other qualifications","67","62","73","137","56","395"
201819,"Preston","LADU","Total","1314","304","591","312","142","2663"
201819,"Preston","LADU","Level 3","1147","167","387","128","60","1889"
201819,"Preston","LADU","Level 2","106","78","114","58","25","381"
201819,"Preston","LADU","All other qualifications","61","59","90","126","57","393"
201920,"Preston","LADU","Total","1352","240","576","309","140","2617"
201920,"Preston","LADU","Level 3","1155","112","370","120","73","1830"
201920,"Preston","LADU","Level 2","98","57","92","63","14","324"
201920,"Preston","LADU","All other qualifications","99","71","114","126","53","463"
202021,"Preston","LADU","Total","1357","206","537","392","116","2608"
202021,"Preston","LADU","Level 3","1127","94","341","156","57","1775"
202021,"Preston","LADU","Level 2","131","46","93","71","15","356"
202021,"Preston","LADU","All other qualifications","99","66","103","165","44","477"
201718,"Ribble Valley","LADU","Total","201","23","47","14","6","291"
201718,"Ribble Valley","LADU","Level 3","200","22","47","14","5","288"
201718,"Ribble Valley","LADU","Level 2","0","0","0","0","1","1"
201718,"Ribble Valley","LADU","All other qualifications","1","1","0","0","0","2"
201819,"Ribble Valley","LADU","Total","224","19","40","12","11","306"
201819,"Ribble Valley","LADU","Level 3","223","17","40","11","10","301"
201819,"Ribble Valley","LADU","All other qualifications","1","2","0","1","1","5"
201920,"Ribble Valley","LADU","Total","222","19","54","15","8","318"
201920,"Ribble Valley","LADU","Level 3","221","19","54","14","8","316"
201920,"Ribble Valley","LADU","Level 2","1","0","0","0","0","1"
201920,"Ribble Valley","LADU","All other qualifications","0","0","0","1","0","1"
202021,"Ribble Valley","LADU","Total","209","16","38","22","10","295"
202021,"Ribble Valley","LADU","Level 3","209","15","36","20","10","290"
202021,"Ribble Valley","LADU","All other qualifications","0","1","2","2","0","5"
201718,"Rochdale","LADU","Total","951","196","433","327","83","1990"
201718,"Rochdale","LADU","Level 3","654","90","258","106","36","1144"
201718,"Rochdale","LADU","Level 2","204","58","94","78","12","446"
201718,"Rochdale","LADU","All other qualifications","93","48","81","143","35","400"
201819,"Rochdale","LADU","Total","1002","209","408","320","86","2025"
201819,"Rochdale","LADU","Level 3","694","79","205","104","20","1102"
201819,"Rochdale","LADU","Level 2","217","75","110","96","25","523"
201819,"Rochdale","LADU","All other qualifications","91","55","93","120","41","400"
201920,"Rochdale","LADU","Total","1049","181","407","336","98","2071"
201920,"Rochdale","LADU","Level 3","736","73","226","141","32","1208"
201920,"Rochdale","LADU","Level 2","194","51","72","77","19","413"
201920,"Rochdale","LADU","All other qualifications","119","57","109","118","47","450"
202021,"Rochdale","LADU","Total","1233","155","344","440","117","2289"
202021,"Rochdale","LADU","Level 3","810","53","180","185","62","1290"
202021,"Rochdale","LADU","Level 2","299","51","82","120","24","576"
202021,"Rochdale","LADU","All other qualifications","124","51","82","135","31","423"
201718,"Rossendale","LADU","Total","239","34","58","34","13","378"
201718,"Rossendale","LADU","Level 3","237","33","56","32","12","370"
201718,"Rossendale","LADU","Level 2","1","0","1","0","1","3"
201718,"Rossendale","LADU","All other qualifications","1","1","1","2","0","5"
201819,"Rossendale","LADU","Total","289","33","48","23","15","408"
201819,"Rossendale","LADU","Level 3","287","32","48","21","13","401"
201819,"Rossendale","LADU","Level 2","0","1","0","2","1","4"
201819,"Rossendale","LADU","All other qualifications","2","0","0","0","1","3"
201920,"Rossendale","LADU","Total","220","19","62","27","11","339"
201920,"Rossendale","LADU","Level 3","220","18","62","24","9","333"
201920,"Rossendale","LADU","Level 2","0","1","0","1","1","3"
201920,"Rossendale","LADU","All other qualifications","0","0","0","2","1","3"
202021,"Rossendale","LADU","Total","265","16","63","37","10","391"
202021,"Rossendale","LADU","Level 3","260","13","61","32","10","376"
202021,"Rossendale","LADU","Level 2","4","3","1","1","0","9"
202021,"Rossendale","LADU","All other qualifications","1","0","1","4","0","6"
201718,"Salford","LADU","Total","934","247","741","378","145","2445"
201718,"Salford","LADU","Level 3","813","146","500","184","63","1706"
201718,"Salford","LADU","Level 2","46","48","122","79","23","318"
201718,"Salford","LADU","All other qualifications","75","53","119","115","59","421"
201819,"Salford","LADU","Total","1112","192","610","365","104","2383"
201819,"Salford","LADU","Level 3","737","121","334","134","32","1358"
201819,"Salford","LADU","Level 2","302","34","188","116","23","663"
201819,"Salford","LADU","All other qualifications","73","37","88","115","49","362"
201920,"Salford","LADU","Total","886","207","470","379","106","2048"
201920,"Salford","LADU","Level 3","740","99","299","154","49","1341"
201920,"Salford","LADU","Level 2","85","60","82","73","9","309"
201920,"Salford","LADU","All other qualifications","61","48","89","152","48","398"
202021,"Salford","LADU","Total","1163","168","465","410","102","2308"
202021,"Salford","LADU","Level 3","831","72","270","184","53","1410"
202021,"Salford","LADU","Level 2","202","56","92","80","13","443"
202021,"Salford","LADU","All other qualifications","130","40","103","146","36","455"
201718,"Sefton","LADU","Total","1349","302","627","375","168","2821"
201718,"Sefton","LADU","Level 3","1117","131","425","182","96","1951"
201718,"Sefton","LADU","Level 2","169","82","113","95","29","488"
201718,"Sefton","LADU","All other qualifications","63","89","89","98","43","382"
201819,"Sefton","LADU","Total","1174","293","631","443","141","2682"
201819,"Sefton","LADU","Level 3","898","95","362","163","54","1572"
201819,"Sefton","LADU","Level 2","185","101","157","127","33","603"
201819,"Sefton","LADU","All other qualifications","91","97","112","153","54","507"
201920,"Sefton","LADU","Total","1224","223","655","386","132","2620"
201920,"Sefton","LADU","Level 3","899","79","395","138","56","1567"
201920,"Sefton","LADU","Level 2","214","80","140","120","31","585"
201920,"Sefton","LADU","All other qualifications","111","64","120","128","45","468"
202021,"Sefton","LADU","Total","1244","174","600","425","108","2551"
202021,"Sefton","LADU","Level 3","937","46","357","154","48","1542"
202021,"Sefton","LADU","Level 2","203","53","139","126","22","543"
202021,"Sefton","LADU","All other qualifications","104","75","104","145","38","466"
201718,"South Lakeland","LADU","Total","499","129","376","105","68","1177"
201718,"South Lakeland","LADU","Level 3","460","61","258","53","47","879"
201718,"South Lakeland","LADU","Level 2","30","51","82","30","12","205"
201718,"South Lakeland","LADU","All other qualifications","9","17","36","22","9","93"
201819,"South Lakeland","LADU","Total","437","102","371","105","51","1066"
201819,"South Lakeland","LADU","Level 3","389","45","219","61","37","751"
201819,"South Lakeland","LADU","Level 2","45","40","109","28","7","229"
201819,"South Lakeland","LADU","All other qualifications","3","17","43","16","7","86"
201920,"South Lakeland","LADU","Total","471","106","306","127","49","1059"
201920,"South Lakeland","LADU","Level 3","438","57","218","84","40","837"
201920,"South Lakeland","LADU","Level 2","23","29","52","21","6","131"
201920,"South Lakeland","LADU","All other qualifications","10","20","36","22","3","91"
202021,"South Lakeland","LADU","Total","550","117","344","150","48","1209"
202021,"South Lakeland","LADU","Level 3","442","64","242","74","36","858"
202021,"South Lakeland","LADU","Level 2","78","36","51","39","1","205"
202021,"South Lakeland","LADU","All other qualifications","30","17","51","37","11","146"
201718,"South Ribble","LADU","Total","1443","217","501","183","82","2426"
201718,"South Ribble","LADU","Level 3","1266","126","380","105","53","1930"
201718,"South Ribble","LADU","Level 2","147","48","73","39","10","317"
201718,"South Ribble","LADU","All other qualifications","30","43","48","39","19","179"
201819,"South Ribble","LADU","Total","1271","260","513","189","69","2302"
201819,"South Ribble","LADU","Level 3","1076","160","353","95","49","1733"
201819,"South Ribble","LADU","Level 2","156","57","108","56","14","391"
201819,"South Ribble","LADU","All other qualifications","39","43","52","38","6","178"
201920,"South Ribble","LADU","Total","1402","245","542","204","90","2483"
201920,"South Ribble","LADU","Level 3","1318","163","428","110","56","2075"
201920,"South Ribble","LADU","Level 2","48","35","67","41","9","200"
201920,"South Ribble","LADU","All other qualifications","36","47","47","53","25","208"
202021,"South Ribble","LADU","Total","1343","188","550","246","73","2400"
202021,"South Ribble","LADU","Level 3","1196","107","421","160","45","1929"
202021,"South Ribble","LADU","Level 2","78","32","72","44","7","233"
202021,"South Ribble","LADU","All other qualifications","69","49","57","42","21","238"
201718,"St. Helens","LADU","Total","1056","271","532","275","105","2239"
201718,"St. Helens","LADU","Level 3","895","152","329","110","37","1523"
201718,"St. Helens","LADU","Level 2","109","56","140","73","24","402"
201718,"St. Helens","LADU","All other qualifications","52","63","63","92","44","314"
201819,"St. Helens","LADU","Total","1052","280","456","299","76","2163"
201819,"St. Helens","LADU","Level 3","905","125","257","109","25","1421"
201819,"St. Helens","LADU","Level 2","103","98","125","88","16","430"
201819,"St. Helens","LADU","All other qualifications","44","57","74","102","35","312"
201920,"St. Helens","LADU","Total","1036","252","569","312","92","2261"
201920,"St. Helens","LADU","Level 3","876","108","317","120","41","1462"
201920,"St. Helens","LADU","Level 2","89","75","142","83","15","404"
201920,"St. Helens","LADU","All other qualifications","71","69","110","109","36","395"
202021,"St. Helens","LADU","Total","1268","210","533","482","88","2581"
202021,"St. Helens","LADU","Level 3","1014","84","269","173","33","1573"
202021,"St. Helens","LADU","Level 2","152","55","139","127","22","495"
202021,"St. Helens","LADU","All other qualifications","102","71","125","182","33","513"
201718,"Stockport","LADU","Total","1158","334","663","345","157","2657"
201718,"Stockport","LADU","Level 3","1026","212","475","162","72","1947"
201718,"Stockport","LADU","Level 2","86","72","104","83","31","376"
201718,"Stockport","LADU","All other qualifications","46","50","84","100","54","334"
201819,"Stockport","LADU","Total","1213","338","610","296","112","2569"
201819,"Stockport","LADU","Level 3","924","221","420","147","56","1768"
201819,"Stockport","LADU","Level 2","220","60","116","68","14","478"
201819,"Stockport","LADU","All other qualifications","69","57","74","81","42","323"
201920,"Stockport","LADU","Total","958","263","561","280","104","2166"
201920,"Stockport","LADU","Level 3","889","172","419","144","63","1687"
201920,"Stockport","LADU","Level 2","41","36","69","52","15","213"
201920,"Stockport","LADU","All other qualifications","28","55","73","84","26","266"
202021,"Stockport","LADU","Total","1099","177","428","261","88","2053"
202021,"Stockport","LADU","Level 3","949","112","332","171","54","1618"
202021,"Stockport","LADU","Level 2","94","24","38","43","17","216"
202021,"Stockport","LADU","All other qualifications","56","41","58","47","17","219"
201718,"Tameside","LADU","Total","949","279","502","311","115","2156"
201718,"Tameside","LADU","Level 3","792","131","286","124","38","1371"
201718,"Tameside","LADU","Level 2","83","77","137","75","31","403"
201718,"Tameside","LADU","All other qualifications","74","71","79","112","46","382"
201819,"Tameside","LADU","Total","837","262","512","340","106","2057"
201819,"Tameside","LADU","Level 3","705","139","258","118","31","1251"
201819,"Tameside","LADU","Level 2","101","67","158","129","37","492"
201819,"Tameside","LADU","All other qualifications","31","56","96","93","38","314"
201920,"Tameside","LADU","Total","903","239","534","366","116","2158"
201920,"Tameside","LADU","Level 3","822","135","338","149","42","1486"
201920,"Tameside","LADU","Level 2","41","47","124","117","30","359"
201920,"Tameside","LADU","All other qualifications","40","57","72","100","44","313"
202021,"Tameside","LADU","Total","1195","204","496","509","107","2511"
202021,"Tameside","LADU","Level 3","809","84","321","237","49","1500"
202021,"Tameside","LADU","Level 2","279","58","93","152","27","609"
202021,"Tameside","LADU","All other qualifications","107","62","82","120","31","402"
201718,"Trafford","LADU","Total","1328","216","467","226","106","2343"
201718,"Trafford","LADU","Level 3","1136","109","295","104","50","1694"
201718,"Trafford","LADU","Level 2","140","70","110","57","22","399"
201718,"Trafford","LADU","All other qualifications","52","37","62","65","34","250"
201819,"Trafford","LADU","Total","1435","200","515","263","95","2508"
201819,"Trafford","LADU","Level 3","1187","104","289","111","46","1737"
201819,"Trafford","LADU","Level 2","188","47","153","79","20","487"
201819,"Trafford","LADU","All other qualifications","60","49","73","73","29","284"
201920,"Trafford","LADU","Total","1298","177","521","241","123","2360"
201920,"Trafford","LADU","Level 3","1163","81","310","104","66","1724"
201920,"Trafford","LADU","Level 2","77","53","127","67","26","350"
201920,"Trafford","LADU","All other qualifications","58","43","84","70","31","286"
202021,"Trafford","LADU","Total","1765","192","519","489","146","3111"
202021,"Trafford","LADU","Level 3","1333","93","270","200","76","1972"
202021,"Trafford","LADU","Level 2","287","44","147","155","30","663"
202021,"Trafford","LADU","All other qualifications","145","55","102","134","40","476"
201718,"Warrington","LADU","Total","891","238","594","247","85","2055"
201718,"Warrington","LADU","Level 3","824","138","423","116","44","1545"
201718,"Warrington","LADU","Level 2","47","37","96","54","26","260"
201718,"Warrington","LADU","All other qualifications","20","63","75","77","15","250"
201819,"Warrington","LADU","Total","911","303","685","299","78","2276"
201819,"Warrington","LADU","Level 3","805","154","425","145","34","1563"
201819,"Warrington","LADU","Level 2","80","89","191","87","29","476"
201819,"Warrington","LADU","All other qualifications","26","60","69","67","15","237"
201920,"Warrington","LADU","Total","887","281","597","308","87","2160"
201920,"Warrington","LADU","Level 3","845","149","433","149","48","1624"
201920,"Warrington","LADU","Level 2","26","61","118","67","10","282"
201920,"Warrington","LADU","All other qualifications","16","71","46","92","29","254"
202021,"Warrington","LADU","Total","1240","205","576","404","86","2511"
202021,"Warrington","LADU","Level 3","1026","93","390","188","47","1744"
202021,"Warrington","LADU","Level 2","160","54","110","102","11","437"
202021,"Warrington","LADU","All other qualifications","54","58","76","114","28","330"
201718,"West Lancashire","LADU","Total","68","9","15","5","3","100"
201718,"West Lancashire","LADU","Level 3","68","7","15","4","3","97"
201718,"West Lancashire","LADU","Level 2","0","2","0","0","0","2"
201718,"West Lancashire","LADU","All other qualifications","0","0","0","1","0","1"
201819,"West Lancashire","LADU","Total","47","9","18","5","1","80"
201819,"West Lancashire","LADU","Level 3","47","8","18","5","1","79"
201819,"West Lancashire","LADU","All other qualifications","0","1","0","0","0","1"
201920,"West Lancashire","LADU","Total","47","6","21","7","1","82"
201920,"West Lancashire","LADU","Level 3","47","6","21","7","1","82"
202021,"West Lancashire","LADU","Total","51","3","25","11","1","91"
202021,"West Lancashire","LADU","Level 3","49","1","25","9","1","85"
202021,"West Lancashire","LADU","Level 2","0","0","0","1","0","1"
202021,"West Lancashire","LADU","All other qualifications","2","2","0","1","0","5"
201718,"Wigan","LADU","Total","1618","489","705","385","129","3326"
201718,"Wigan","LADU","Level 3","1444","295","465","185","67","2456"
201718,"Wigan","LADU","Level 2","128","98","162","87","28","503"
201718,"Wigan","LADU","All other qualifications","46","96","78","113","34","367"
201819,"Wigan","LADU","Total","1682","391","738","386","123","3320"
201819,"Wigan","LADU","Level 3","1361","208","453","131","51","2204"
201819,"Wigan","LADU","Level 2","240","106","186","118","28","678"
201819,"Wigan","LADU","All other qualifications","81","77","99","137","44","438"
201920,"Wigan","LADU","Total","1538","365","759","413","102","3177"
201920,"Wigan","LADU","Level 3","1365","192","490","178","40","2265"
201920,"Wigan","LADU","Level 2","119","80","166","91","19","475"
201920,"Wigan","LADU","All other qualifications","54","93","103","144","43","437"
202021,"Wigan","LADU","Total","1743","325","701","502","100","3371"
202021,"Wigan","LADU","Level 3","1503","128","431","245","46","2353"
202021,"Wigan","LADU","Level 2","148","99","148","94","17","506"
202021,"Wigan","LADU","All other qualifications","92","98","122","163","37","512"
201718,"Wirral","LADU","Total","1810","293","630","337","145","3215"
201718,"Wirral","LADU","Level 3","1604","157","469","155","80","2465"
201718,"Wirral","LADU","Level 2","136","77","91","84","20","408"
201718,"Wirral","LADU","All other qualifications","70","59","70","98","45","342"
201819,"Wirral","LADU","Total","1515","249","625","420","119","2928"
201819,"Wirral","LADU","Level 3","1380","134","409","183","65","2171"
201819,"Wirral","LADU","Level 2","89","70","121","108","22","410"
201819,"Wirral","LADU","All other qualifications","46","45","95","129","32","347"
201920,"Wirral","LADU","Total","1639","306","674","460","150","3229"
201920,"Wirral","LADU","Level 3","1408","163","439","192","89","2291"
201920,"Wirral","LADU","Level 2","155","57","128","117","19","476"
201920,"Wirral","LADU","All other qualifications","76","86","107","151","42","462"
202021,"Wirral","LADU","Total","1761","191","584","500","116","3152"
202021,"Wirral","LADU","Level 3","1501","87","355","234","54","2231"
202021,"Wirral","LADU","Level 2","155","39","90","88","15","387"
202021,"Wirral","LADU","All other qualifications","105","65","139","178","47","534"
201718,"Wyre","LADU","Total","199","82","248","149","70","748"
201718,"Wyre","LADU","Level 3","162","30","161","59","28","440"
201718,"Wyre","LADU","Level 2","13","37","46","42","12","150"
201718,"Wyre","LADU","All other qualifications","24","15","41","48","30","158"
201819,"Wyre","LADU","Total","286","101","241","177","94","899"
201819,"Wyre","LADU","Level 3","174","43","132","59","33","441"
201819,"Wyre","LADU","Level 2","63","42","74","37","18","234"
201819,"Wyre","LADU","All other qualifications","49","16","35","81","43","224"
201920,"Wyre","LADU","Total","164","57","209","172","82","684"
201920,"Wyre","LADU","Level 3","123","20","122","58","25","348"
201920,"Wyre","LADU","Level 2","13","25","49","35","16","138"
201920,"Wyre","LADU","All other qualifications","28","12","38","79","41","198"
202021,"Wyre","LADU","Total","302","62","204","208","69","845"
202021,"Wyre","LADU","Level 3","185","19","125","63","29","421"
202021,"Wyre","LADU","Level 2","47","20","40","40","12","159"
202021,"Wyre","LADU","All other qualifications","70","23","39","105","28","265"
201718,"Barnsley","LADU","Total","915","304","558","351","143","2271"
201718,"Barnsley","LADU","Level 3","681","125","306","122","55","1289"
201718,"Barnsley","LADU","Level 2","185","107","163","115","42","612"
201718,"Barnsley","LADU","All other qualifications","49","72","89","114","46","370"
201819,"Barnsley","LADU","Total","855","268","600","349","91","2163"
201819,"Barnsley","LADU","Level 3","596","110","269","100","23","1098"
201819,"Barnsley","LADU","Level 2","199","94","241","130","31","695"
201819,"Barnsley","LADU","All other qualifications","60","64","90","119","37","370"
201920,"Barnsley","LADU","Total","1014","320","643","402","131","2510"
201920,"Barnsley","LADU","Level 3","790","138","368","155","52","1503"
201920,"Barnsley","LADU","Level 2","133","117","161","115","24","550"
201920,"Barnsley","LADU","All other qualifications","91","65","114","132","55","457"
202021,"Barnsley","LADU","Total","1050","204","600","457","111","2422"
202021,"Barnsley","LADU","Level 3","793","76","335","153","37","1394"
202021,"Barnsley","LADU","Level 2","141","62","131","114","20","468"
202021,"Barnsley","LADU","All other qualifications","116","66","134","190","54","560"
201718,"Bradford","LADU","Total","2662","397","817","828","389","5093"
201718,"Bradford","LADU","Level 3","2183","206","484","328","146","3347"
201718,"Bradford","LADU","Level 2","263","116","181","188","77","825"
201718,"Bradford","LADU","All other qualifications","216","75","152","312","166","921"
201819,"Bradford","LADU","Total","2583","322","795","769","322","4791"
201819,"Bradford","LADU","Level 3","1907","158","444","244","99","2852"
201819,"Bradford","LADU","Level 2","453","110","205","224","85","1077"
201819,"Bradford","LADU","All other qualifications","223","54","146","301","138","862"
201920,"Bradford","LADU","Total","2400","303","679","664","287","4333"
201920,"Bradford","LADU","Level 3","2004","157","393","243","108","2905"
201920,"Bradford","LADU","Level 2","218","74","158","167","54","671"
201920,"Bradford","LADU","All other qualifications","178","72","128","254","125","757"
202021,"Bradford","LADU","Total","2711","248","535","868","289","4651"
202021,"Bradford","LADU","Level 3","2088","91","278","286","98","2841"
202021,"Bradford","LADU","Level 2","386","79","138","240","73","916"
202021,"Bradford","LADU","All other qualifications","237","78","119","342","118","894"
201718,"Calderdale","LADU","Total","931","193","394","299","137","1954"
201718,"Calderdale","LADU","Level 3","809","114","290","134","68","1415"
201718,"Calderdale","LADU","Level 2","86","43","46","57","25","257"
201718,"Calderdale","LADU","All other qualifications","36","36","58","108","44","282"
201819,"Calderdale","LADU","Total","879","212","426","357","129","2003"
201819,"Calderdale","LADU","Level 3","754","114","273","126","58","1325"
201819,"Calderdale","LADU","Level 2","92","58","92","94","30","366"
201819,"Calderdale","LADU","All other qualifications","33","40","61","137","41","312"
201920,"Calderdale","LADU","Total","835","245","341","304","116","1841"
201920,"Calderdale","LADU","Level 3","709","128","231","123","55","1246"
201920,"Calderdale","LADU","Level 2","65","73","75","69","15","297"
201920,"Calderdale","LADU","All other qualifications","61","44","35","112","46","298"
202021,"Calderdale","LADU","Total","844","202","294","331","106","1777"
202021,"Calderdale","LADU","Level 3","679","84","193","135","43","1134"
202021,"Calderdale","LADU","Level 2","102","49","52","64","19","286"
202021,"Calderdale","LADU","All other qualifications","63","69","49","132","44","357"
201718,"Craven","LADU","Total","456","146","369","123","58","1152"
201718,"Craven","LADU","Level 3","424","78","238","54","27","821"
201718,"Craven","LADU","Level 2","23","46","90","36","20","215"
201718,"Craven","LADU","All other qualifications","9","22","41","33","11","116"
201819,"Craven","LADU","Total","449","147","303","157","58","1114"
201819,"Craven","LADU","Level 3","401","75","180","73","23","752"
201819,"Craven","LADU","Level 2","41","57","102","54","25","279"
201819,"Craven","LADU","All other qualifications","7","15","21","30","10","83"
201920,"Craven","LADU","Total","528","111","296","166","57","1158"
201920,"Craven","LADU","Level 3","472","63","208","81","28","852"
201920,"Craven","LADU","Level 2","39","32","50","47","13","181"
201920,"Craven","LADU","All other qualifications","17","16","38","38","16","125"
202021,"Craven","LADU","Total","465","101","217","147","33","963"
202021,"Craven","LADU","Level 3","384","45","140","77","21","667"
202021,"Craven","LADU","Level 2","56","40","45","35","3","179"
202021,"Craven","LADU","All other qualifications","25","16","32","35","9","117"
201718,"Doncaster","LADU","Total","966","317","647","360","155","2445"
201718,"Doncaster","LADU","Level 3","827","165","379","150","63","1584"
201718,"Doncaster","LADU","Level 2","72","65","163","97","41","438"
201718,"Doncaster","LADU","All other qualifications","67","87","105","113","51","423"
201819,"Doncaster","LADU","Total","889","279","658","414","108","2348"
201819,"Doncaster","LADU","Level 3","753","129","293","118","24","1317"
201819,"Doncaster","LADU","Level 2","102","83","256","180","40","661"
201819,"Doncaster","LADU","All other qualifications","34","67","109","116","44","370"
201920,"Doncaster","LADU","Total","833","211","380","220","75","1719"
201920,"Doncaster","LADU","Level 3","821","119","256","82","22","1300"
201920,"Doncaster","LADU","Level 2","7","30","44","52","13","146"
201920,"Doncaster","LADU","All other qualifications","5","62","80","86","40","273"
202021,"Doncaster","LADU","Total","846","125","324","238","81","1614"
202021,"Doncaster","LADU","Level 3","805","48","235","122","39","1249"
202021,"Doncaster","LADU","Level 2","13","24","36","33","15","121"
202021,"Doncaster","LADU","All other qualifications","28","53","53","83","27","244"
201718,"East Riding of Yorkshire","LADU","Total","1060","271","627","313","144","2415"
201718,"East Riding of Yorkshire","LADU","Level 3","976","148","403","131","68","1726"
201718,"East Riding of Yorkshire","LADU","Level 2","50","63","122","84","41","360"
201718,"East Riding of Yorkshire","LADU","All other qualifications","34","60","102","98","35","329"
201819,"East Riding of Yorkshire","LADU","Total","1072","244","622","348","121","2407"
201819,"East Riding of Yorkshire","LADU","Level 3","928","138","367","127","51","1611"
201819,"East Riding of Yorkshire","LADU","Level 2","98","64","176","119","34","491"
201819,"East Riding of Yorkshire","LADU","All other qualifications","46","42","79","102","36","305"
201920,"East Riding of Yorkshire","LADU","Total","1118","240","611","382","100","2451"
201920,"East Riding of Yorkshire","LADU","Level 3","943","147","409","169","59","1727"
201920,"East Riding of Yorkshire","LADU","Level 2","108","51","124","100","17","400"
201920,"East Riding of Yorkshire","LADU","All other qualifications","67","42","78","113","24","324"
202021,"East Riding of Yorkshire","LADU","Total","1299","233","563","375","77","2547"
202021,"East Riding of Yorkshire","LADU","Level 3","1076","123","354","181","36","1770"
202021,"East Riding of Yorkshire","LADU","Level 2","114","43","121","73","17","368"
202021,"East Riding of Yorkshire","LADU","All other qualifications","109","67","88","121","24","409"
201718,"Hambleton","LADU","Total","227","35","82","16","7","367"
201718,"Hambleton","LADU","Level 3","225","30","76","12","6","349"
201718,"Hambleton","LADU","Level 2","1","1","3","2","1","8"
201718,"Hambleton","LADU","All other qualifications","1","4","3","2","0","10"
201819,"Hambleton","LADU","Total","188","24","56","19","4","291"
201819,"Hambleton","LADU","Level 3","188","23","55","16","3","285"
201819,"Hambleton","LADU","Level 2","0","0","1","2","1","4"
201819,"Hambleton","LADU","All other qualifications","0","1","0","1","0","2"
201920,"Hambleton","LADU","Total","210","18","51","12","6","297"
201920,"Hambleton","LADU","Level 3","210","16","42","10","3","281"
201920,"Hambleton","LADU","Level 2","0","2","6","2","2","12"
201920,"Hambleton","LADU","All other qualifications","0","0","3","0","1","4"
202021,"Hambleton","LADU","Total","139","13","44","17","7","220"
202021,"Hambleton","LADU","Level 3","137","9","37","13","7","203"
202021,"Hambleton","LADU","Level 2","0","3","2","4","0","9"
202021,"Hambleton","LADU","All other qualifications","2","1","5","0","0","8"
201718,"Harrogate","LADU","Total","756","68","319","75","34","1252"
201718,"Harrogate","LADU","Level 3","751","60","307","70","30","1218"
201718,"Harrogate","LADU","Level 2","1","4","4","3","2","14"
201718,"Harrogate","LADU","All other qualifications","4","4","8","2","2","20"
201819,"Harrogate","LADU","Total","752","64","309","67","31","1223"
201819,"Harrogate","LADU","Level 3","737","57","297","61","26","1178"
201819,"Harrogate","LADU","Level 2","7","2","8","2","3","22"
201819,"Harrogate","LADU","All other qualifications","8","5","4","4","2","23"
201920,"Harrogate","LADU","Total","731","64","307","92","33","1227"
201920,"Harrogate","LADU","Level 3","722","56","287","80","26","1171"
201920,"Harrogate","LADU","Level 2","1","1","12","3","1","18"
201920,"Harrogate","LADU","All other qualifications","8","7","8","9","6","38"
202021,"Harrogate","LADU","Total","787","41","295","94","22","1239"
202021,"Harrogate","LADU","Level 3","778","35","279","81","21","1194"
202021,"Harrogate","LADU","Level 2","0","2","4","1","1","8"
202021,"Harrogate","LADU","All other qualifications","9","4","12","12","0","37"
201718,"Kingston upon Hull, City of","LADU","Total","1425","482","943","658","213","3721"
201718,"Kingston upon Hull, City of","LADU","Level 3","1217","216","508","229","74","2244"
201718,"Kingston upon Hull, City of","LADU","Level 2","152","132","247","185","51","767"
201718,"Kingston upon Hull, City of","LADU","All other qualifications","56","134","188","244","88","710"
201819,"Kingston upon Hull, City of","LADU","Total","1293","456","785","615","156","3305"
201819,"Kingston upon Hull, City of","LADU","Level 3","1050","190","398","185","59","1882"
201819,"Kingston upon Hull, City of","LADU","Level 2","168","149","246","228","45","836"
201819,"Kingston upon Hull, City of","LADU","All other qualifications","75","117","141","202","52","587"
201920,"Kingston upon Hull, City of","LADU","Total","1321","428","735","576","172","3232"
201920,"Kingston upon Hull, City of","LADU","Level 3","1107","202","427","196","74","2006"
201920,"Kingston upon Hull, City of","LADU","Level 2","118","105","174","167","28","592"
201920,"Kingston upon Hull, City of","LADU","All other qualifications","96","121","134","213","70","634"
202021,"Kingston upon Hull, City of","LADU","Total","1712","331","584","643","134","3404"
202021,"Kingston upon Hull, City of","LADU","Level 3","1286","136","325","254","50","2051"
202021,"Kingston upon Hull, City of","LADU","Level 2","265","70","128","187","24","674"
202021,"Kingston upon Hull, City of","LADU","All other qualifications","161","125","131","202","60","679"
201718,"Kirklees","LADU","Total","2719","518","781","563","261","4842"
201718,"Kirklees","LADU","Level 3","2466","274","521","274","143","3678"
201718,"Kirklees","LADU","Level 2","150","142","163","115","43","613"
201718,"Kirklees","LADU","All other qualifications","103","102","97","174","75","551"
201819,"Kirklees","LADU","Total","2467","432","819","563","210","4491"
201819,"Kirklees","LADU","Level 3","2031","186","471","226","100","3014"
201819,"Kirklees","LADU","Level 2","328","169","240","170","37","944"
201819,"Kirklees","LADU","All other qualifications","108","77","108","167","73","533"
201920,"Kirklees","LADU","Total","2421","401","855","602","212","4491"
201920,"Kirklees","LADU","Level 3","2164","222","598","289","118","3391"
201920,"Kirklees","LADU","Level 2","146","100","135","124","30","535"
201920,"Kirklees","LADU","All other qualifications","111","79","122","189","64","565"
202021,"Kirklees","LADU","Total","3032","329","800","778","215","5154"
202021,"Kirklees","LADU","Level 3","2414","161","554","393","129","3651"
202021,"Kirklees","LADU","Level 2","412","79","124","178","27","820"
202021,"Kirklees","LADU","All other qualifications","206","89","122","207","59","683"
201718,"Leeds","LADU","Total","3485","860","1676","1005","388","7414"
201718,"Leeds","LADU","Level 3","2862","487","1066","378","141","4934"
201718,"Leeds","LADU","Level 2","412","198","352","235","95","1292"
201718,"Leeds","LADU","All other qualifications","211","175","258","392","152","1188"
201819,"Leeds","LADU","Total","3030","839","1571","954","381","6775"
201819,"Leeds","LADU","Level 3","2616","428","931","357","137","4469"
201819,"Leeds","LADU","Level 2","288","241","396","277","92","1294"
201819,"Leeds","LADU","All other qualifications","126","170","244","320","152","1012"
201920,"Leeds","LADU","Total","3460","799","1670","1170","385","7484"
201920,"Leeds","LADU","Level 3","2780","367","998","442","173","4760"
201920,"Leeds","LADU","Level 2","485","220","405","399","82","1591"
201920,"Leeds","LADU","All other qualifications","195","212","267","329","130","1133"
202021,"Leeds","LADU","Total","4273","678","1458","1378","412","8199"
202021,"Leeds","LADU","Level 3","3369","311","862","528","168","5238"
202021,"Leeds","LADU","Level 2","655","177","332","464","111","1739"
202021,"Leeds","LADU","All other qualifications","249","190","264","386","133","1222"
201718,"North East Lincolnshire","LADU","Total","942","309","565","414","135","2365"
201718,"North East Lincolnshire","LADU","Level 3","684","140","308","118","50","1300"
201718,"North East Lincolnshire","LADU","Level 2","159","96","151","117","27","550"
201718,"North East Lincolnshire","LADU","All other qualifications","99","73","106","179","58","515"
201819,"North East Lincolnshire","LADU","Total","910","286","548","448","116","2308"
201819,"North East Lincolnshire","LADU","Level 3","605","121","242","132","39","1139"
201819,"North East Lincolnshire","LADU","Level 2","236","98","196","132","30","692"
201819,"North East Lincolnshire","LADU","All other qualifications","69","67","110","184","47","477"
201920,"North East Lincolnshire","LADU","Total","907","235","492","433","114","2181"
201920,"North East Lincolnshire","LADU","Level 3","678","107","238","133","47","1203"
201920,"North East Lincolnshire","LADU","Level 2","142","79","134","128","25","508"
201920,"North East Lincolnshire","LADU","All other qualifications","87","49","120","172","42","470"
202021,"North East Lincolnshire","LADU","Total","1048","182","480","519","80","2309"
202021,"North East Lincolnshire","LADU","Level 3","746","77","253","151","25","1252"
202021,"North East Lincolnshire","LADU","Level 2","193","52","126","132","16","519"
202021,"North East Lincolnshire","LADU","All other qualifications","109","53","101","236","39","538"
201718,"North Lincolnshire","LADU","Total","787","242","447","236","106","1818"
201718,"North Lincolnshire","LADU","Level 3","626","117","262","96","48","1149"
201718,"North Lincolnshire","LADU","Level 2","105","62","117","61","23","368"
201718,"North Lincolnshire","LADU","All other qualifications","56","63","68","79","35","301"
201819,"North Lincolnshire","LADU","Total","701","240","456","258","99","1754"
201819,"North Lincolnshire","LADU","Level 3","607","125","276","95","51","1154"
201819,"North Lincolnshire","LADU","Level 2","56","70","110","93","20","349"
201819,"North Lincolnshire","LADU","All other qualifications","38","45","70","70","28","251"
201920,"North Lincolnshire","LADU","Total","1041","255","610","403","91","2400"
201920,"North Lincolnshire","LADU","Level 3","856","122","357","151","33","1519"
201920,"North Lincolnshire","LADU","Level 2","103","70","142","106","21","442"
201920,"North Lincolnshire","LADU","All other qualifications","82","63","111","146","37","439"
202021,"North Lincolnshire","LADU","Total","1317","299","853","673","154","3296"
202021,"North Lincolnshire","LADU","Level 3","916","116","423","228","63","1746"
202021,"North Lincolnshire","LADU","Level 2","250","84","248","211","39","832"
202021,"North Lincolnshire","LADU","All other qualifications","151","99","182","234","52","718"
201718,"Richmondshire","LADU","Total","102","4","28","7","1","142"
201718,"Richmondshire","LADU","Level 3","101","4","27","4","1","137"
201718,"Richmondshire","LADU","Level 2","1","0","1","0","0","2"
201718,"Richmondshire","LADU","All other qualifications","0","0","0","3","0","3"
201819,"Richmondshire","LADU","Total","84","17","46","9","3","159"
201819,"Richmondshire","LADU","Level 3","84","17","45","9","3","158"
201819,"Richmondshire","LADU","All other qualifications","0","0","1","0","0","1"
201920,"Richmondshire","LADU","Total","73","9","30","9","5","126"
201920,"Richmondshire","LADU","Level 3","73","8","30","8","5","124"
201920,"Richmondshire","LADU","All other qualifications","0","1","0","1","0","2"
202021,"Richmondshire","LADU","Total","88","10","25","10","1","134"
202021,"Richmondshire","LADU","Level 3","87","9","24","9","1","130"
202021,"Richmondshire","LADU","Level 2","1","0","1","0","0","2"
202021,"Richmondshire","LADU","All other qualifications","0","1","0","1","0","2"
201718,"Rotherham","LADU","Total","1403","406","802","421","151","3183"
201718,"Rotherham","LADU","Level 3","1201","214","480","153","58","2106"
201718,"Rotherham","LADU","Level 2","121","108","195","119","28","571"
201718,"Rotherham","LADU","All other qualifications","81","84","127","149","65","506"
201819,"Rotherham","LADU","Total","1470","419","948","547","139","3523"
201819,"Rotherham","LADU","Level 3","1174","199","462","159","46","2040"
201819,"Rotherham","LADU","Level 2","201","118","291","186","38","834"
201819,"Rotherham","LADU","All other qualifications","95","102","195","202","55","649"
201920,"Rotherham","LADU","Total","1274","396","751","487","120","3028"
201920,"Rotherham","LADU","Level 3","1085","163","396","162","43","1849"
201920,"Rotherham","LADU","Level 2","102","106","187","147","32","574"
201920,"Rotherham","LADU","All other qualifications","87","127","168","178","45","605"
202021,"Rotherham","LADU","Total","1510","265","679","589","140","3183"
202021,"Rotherham","LADU","Level 3","1174","99","366","216","57","1912"
202021,"Rotherham","LADU","Level 2","193","91","172","164","23","643"
202021,"Rotherham","LADU","All other qualifications","143","75","141","209","60","628"
201718,"Ryedale","LADU","Total","98","20","69","29","11","227"
201718,"Ryedale","LADU","Level 3","97","17","61","20","11","206"
201718,"Ryedale","LADU","Level 2","1","0","4","2","0","7"
201718,"Ryedale","LADU","All other qualifications","0","3","4","7","0","14"
201819,"Ryedale","LADU","Total","109","23","48","12","8","200"
201819,"Ryedale","LADU","Level 3","109","18","41","10","6","184"
201819,"Ryedale","LADU","Level 2","0","5","4","1","0","10"
201819,"Ryedale","LADU","All other qualifications","0","0","3","1","2","6"
201920,"Ryedale","LADU","Total","107","15","76","26","6","230"
201920,"Ryedale","LADU","Level 3","107","12","63","22","4","208"
201920,"Ryedale","LADU","Level 2","0","1","7","3","1","12"
201920,"Ryedale","LADU","All other qualifications","0","2","6","1","1","10"
202021,"Ryedale","LADU","Total","108","12","34","20","2","176"
202021,"Ryedale","LADU","Level 3","108","8","31","16","2","165"
202021,"Ryedale","LADU","Level 2","0","2","0","3","0","5"
202021,"Ryedale","LADU","All other qualifications","0","2","3","1","0","6"
201718,"Scarborough","LADU","Total","343","41","163","67","14","628"
201718,"Scarborough","LADU","Level 3","338","33","142","55","11","579"
201718,"Scarborough","LADU","Level 2","3","6","14","7","3","33"
201718,"Scarborough","LADU","All other qualifications","2","2","7","5","0","16"
201819,"Scarborough","LADU","Total","321","49","158","63","17","608"
201819,"Scarborough","LADU","Level 3","309","40","117","37","15","518"
201819,"Scarborough","LADU","Level 2","10","5","33","16","2","66"
201819,"Scarborough","LADU","All other qualifications","2","4","8","10","0","24"
201920,"Scarborough","LADU","Total","327","35","122","53","14","551"
201920,"Scarborough","LADU","Level 3","316","26","107","35","10","494"
201920,"Scarborough","LADU","Level 2","6","3","7","13","1","30"
201920,"Scarborough","LADU","All other qualifications","5","6","8","5","3","27"
202021,"Scarborough","LADU","Total","348","41","167","76","23","655"
202021,"Scarborough","LADU","Level 3","310","27","130","53","18","538"
202021,"Scarborough","LADU","Level 2","31","11","24","9","2","77"
202021,"Scarborough","LADU","All other qualifications","7","3","13","14","3","40"
201718,"Selby","LADU","Total","335","148","208","88","48","827"
201718,"Selby","LADU","Level 3","292","94","124","35","16","561"
201718,"Selby","LADU","Level 2","31","36","54","27","14","162"
201718,"Selby","LADU","All other qualifications","12","18","30","26","18","104"
201819,"Selby","LADU","Total","313","106","218","87","22","746"
201819,"Selby","LADU","Level 3","234","32","113","29","6","414"
201819,"Selby","LADU","Level 2","65","54","80","35","10","244"
201819,"Selby","LADU","All other qualifications","14","20","25","23","6","88"
201920,"Selby","LADU","Total","316","117","219","93","19","764"
201920,"Selby","LADU","Level 3","287","50","115","42","9","503"
201920,"Selby","LADU","Level 2","19","44","71","30","4","168"
201920,"Selby","LADU","All other qualifications","10","23","33","21","6","93"
202021,"Selby","LADU","Total","328","82","184","104","10","708"
202021,"Selby","LADU","Level 3","257","32","99","42","6","436"
202021,"Selby","LADU","Level 2","40","26","46","30","1","143"
202021,"Selby","LADU","All other qualifications","31","24","39","32","3","129"
201718,"Sheffield","LADU","Total","2227","533","1152","676","333","4921"
201718,"Sheffield","LADU","Level 3","1967","250","724","280","149","3370"
201718,"Sheffield","LADU","Level 2","147","140","263","151","54","755"
201718,"Sheffield","LADU","All other qualifications","113","143","165","245","130","796"
201819,"Sheffield","LADU","Total","2199","448","1093","676","250","4666"
201819,"Sheffield","LADU","Level 3","1802","217","629","253","93","2994"
201819,"Sheffield","LADU","Level 2","256","132","308","195","47","938"
201819,"Sheffield","LADU","All other qualifications","141","99","156","228","110","734"
201920,"Sheffield","LADU","Total","2405","377","1040","797","248","4867"
201920,"Sheffield","LADU","Level 3","2013","173","620","300","98","3204"
201920,"Sheffield","LADU","Level 2","193","100","228","186","50","757"
201920,"Sheffield","LADU","All other qualifications","199","104","192","311","100","906"
202021,"Sheffield","LADU","Total","2982","316","924","859","230","5311"
202021,"Sheffield","LADU","Level 3","2135","119","542","339","102","3237"
202021,"Sheffield","LADU","Level 2","540","89","189","176","36","1030"
202021,"Sheffield","LADU","All other qualifications","307","108","193","344","92","1044"
201718,"Wakefield","LADU","Total","1465","465","970","558","153","3611"
201718,"Wakefield","LADU","Level 3","1341","290","626","232","70","2559"
201718,"Wakefield","LADU","Level 2","72","88","193","108","22","483"
201718,"Wakefield","LADU","All other qualifications","52","87","151","218","61","569"
201819,"Wakefield","LADU","Total","1372","420","944","568","170","3474"
201819,"Wakefield","LADU","Level 3","1216","236","561","208","57","2278"
201819,"Wakefield","LADU","Level 2","105","108","226","142","34","615"
201819,"Wakefield","LADU","All other qualifications","51","76","157","218","79","581"
201920,"Wakefield","LADU","Total","1461","394","880","605","141","3481"
201920,"Wakefield","LADU","Level 3","1275","230","560","218","55","2338"
201920,"Wakefield","LADU","Level 2","107","80","166","143","27","523"
201920,"Wakefield","LADU","All other qualifications","79","84","154","244","59","620"
202021,"Wakefield","LADU","Total","1729","273","785","633","142","3562"
202021,"Wakefield","LADU","Level 3","1374","143","465","261","58","2301"
202021,"Wakefield","LADU","Level 2","211","66","166","158","33","634"
202021,"Wakefield","LADU","All other qualifications","144","64","154","214","51","627"
201718,"York","LADU","Total","1382","411","1295","482","258","3828"
201718,"York","LADU","Level 3","1257","186","854","222","152","2671"
201718,"York","LADU","Level 2","69","141","304","115","53","682"
201718,"York","LADU","All other qualifications","56","84","137","145","53","475"
201819,"York","LADU","Total","1252","339","1158","493","230","3472"
201819,"York","LADU","Level 3","1063","152","631","180","124","2150"
201819,"York","LADU","Level 2","144","129","404","166","56","899"
201819,"York","LADU","All other qualifications","45","58","123","147","50","423"
201920,"York","LADU","Total","1229","341","1167","528","245","3510"
201920,"York","LADU","Level 3","1087","151","728","219","134","2319"
201920,"York","LADU","Level 2","89","98","273","128","59","647"
201920,"York","LADU","All other qualifications","53","92","166","181","52","544"
202021,"York","LADU","Total","1762","322","1095","612","287","4078"
202021,"York","LADU","Level 3","1498","125","699","247","193","2762"
202021,"York","LADU","Level 2","163","107","233","154","34","691"
202021,"York","LADU","All other qualifications","101","90","163","211","60","625"
201718,"Amber Valley","LADU","Total","292","82","113","47","16","550"
201718,"Amber Valley","LADU","Level 3","282","73","107","39","11","512"
201718,"Amber Valley","LADU","Level 2","6","4","2","6","4","22"
201718,"Amber Valley","LADU","All other qualifications","4","5","4","2","1","16"
201819,"Amber Valley","LADU","Total","265","84","94","34","20","497"
201819,"Amber Valley","LADU","Level 3","257","74","88","28","18","465"
201819,"Amber Valley","LADU","Level 2","4","5","5","4","1","19"
201819,"Amber Valley","LADU","All other qualifications","4","5","1","2","1","13"
201920,"Amber Valley","LADU","Total","295","59","115","41","23","533"
201920,"Amber Valley","LADU","Level 3","285","50","106","34","19","494"
201920,"Amber Valley","LADU","Level 2","1","4","4","3","0","12"
201920,"Amber Valley","LADU","All other qualifications","9","5","5","4","4","27"
202021,"Amber Valley","LADU","Total","302","47","97","47","18","511"
202021,"Amber Valley","LADU","Level 3","290","34","88","38","16","466"
202021,"Amber Valley","LADU","Level 2","7","1","6","6","0","20"
202021,"Amber Valley","LADU","All other qualifications","5","12","3","3","2","25"
201718,"Ashfield","LADU","Total","267","82","145","60","19","573"
201718,"Ashfield","LADU","Level 3","254","54","107","32","13","460"
201718,"Ashfield","LADU","Level 2","12","16","24","21","5","78"
201718,"Ashfield","LADU","All other qualifications","1","12","14","7","1","35"
201819,"Ashfield","LADU","Total","257","73","154","69","24","577"
201819,"Ashfield","LADU","Level 3","233","44","104","40","13","434"
201819,"Ashfield","LADU","Level 2","21","19","47","25","8","120"
201819,"Ashfield","LADU","All other qualifications","3","10","3","4","3","23"
201920,"Ashfield","LADU","Total","230","66","117","41","30","484"
201920,"Ashfield","LADU","Level 3","202","42","86","23","5","358"
201920,"Ashfield","LADU","Level 2","25","13","18","10","3","69"
201920,"Ashfield","LADU","All other qualifications","3","11","13","8","22","57"
202021,"Ashfield","LADU","Total","259","48","118","50","74","549"
202021,"Ashfield","LADU","Level 3","225","33","86","30","15","389"
202021,"Ashfield","LADU","Level 2","23","7","19","11","3","63"
202021,"Ashfield","LADU","All other qualifications","11","8","13","9","56","97"
201718,"Bassetlaw","LADU","Total","275","115","161","84","35","670"
201718,"Bassetlaw","LADU","Level 3","268","56","100","37","12","473"
201718,"Bassetlaw","LADU","Level 2","5","31","24","14","7","81"
201718,"Bassetlaw","LADU","All other qualifications","2","28","37","33","16","116"
201819,"Bassetlaw","LADU","Total","245","73","133","56","24","531"
201819,"Bassetlaw","LADU","Level 3","240","38","96","18","9","401"
201819,"Bassetlaw","LADU","Level 2","3","10","19","10","9","51"
201819,"Bassetlaw","LADU","All other qualifications","2","25","18","28","6","79"
201920,"Bassetlaw","LADU","Total","211","34","96","22","17","380"
201920,"Bassetlaw","LADU","Level 3","208","29","87","17","14","355"
201920,"Bassetlaw","LADU","Level 2","3","1","5","0","0","9"
201920,"Bassetlaw","LADU","All other qualifications","0","4","4","5","3","16"
202021,"Bassetlaw","LADU","Total","283","23","83","33","12","434"
202021,"Bassetlaw","LADU","Level 3","281","18","77","24","10","410"
202021,"Bassetlaw","LADU","Level 2","1","2","5","5","1","14"
202021,"Bassetlaw","LADU","All other qualifications","1","3","1","4","1","10"
201718,"Blaby","LADU","Total","91","11","21","5","3","131"
201718,"Blaby","LADU","Level 3","91","11","20","5","3","130"
201718,"Blaby","LADU","All other qualifications","0","0","1","0","0","1"
201819,"Blaby","LADU","Total","77","13","23","7","5","125"
201819,"Blaby","LADU","Level 3","77","12","23","6","4","122"
201819,"Blaby","LADU","Level 2","0","1","0","0","0","1"
201819,"Blaby","LADU","All other qualifications","0","0","0","1","1","2"
201920,"Blaby","LADU","Total","59","11","18","7","6","101"
201920,"Blaby","LADU","Level 3","59","9","17","7","5","97"
201920,"Blaby","LADU","All other qualifications","0","2","1","0","1","4"
202021,"Blaby","LADU","Total","42","6","14","5","1","68"
202021,"Blaby","LADU","Level 3","42","4","8","2","1","57"
202021,"Blaby","LADU","All other qualifications","0","2","6","3","0","11"
201920,"Bolsover","LADU","Total","0","0","0","1","0","1"
201920,"Bolsover","LADU","Level 2","0","0","0","1","0","1"
201718,"Boston","LADU","Total","440","101","291","143","78","1053"
201718,"Boston","LADU","Level 3","295","40","133","40","42","550"
201718,"Boston","LADU","Level 2","78","38","87","46","8","257"
201718,"Boston","LADU","All other qualifications","67","23","71","57","28","246"
201819,"Boston","LADU","Total","446","106","235","157","72","1016"
201819,"Boston","LADU","Level 3","250","42","82","40","46","460"
201819,"Boston","LADU","Level 2","136","41","96","39","9","321"
201819,"Boston","LADU","All other qualifications","60","23","57","78","17","235"
201920,"Boston","LADU","Total","485","88","265","174","71","1083"
201920,"Boston","LADU","Level 3","361","38","120","46","36","601"
201920,"Boston","LADU","Level 2","71","35","84","53","13","256"
201920,"Boston","LADU","All other qualifications","53","15","61","75","22","226"
202021,"Boston","LADU","Total","463","69","235","190","94","1051"
202021,"Boston","LADU","Level 3","332","23","106","60","48","569"
202021,"Boston","LADU","Level 2","72","23","74","57","15","241"
202021,"Boston","LADU","All other qualifications","59","23","55","73","31","241"
201718,"Broxtowe","LADU","Total","235","42","79","30","13","399"
201718,"Broxtowe","LADU","Level 3","235","38","71","23","10","377"
201718,"Broxtowe","LADU","Level 2","0","3","5","4","3","15"
201718,"Broxtowe","LADU","All other qualifications","0","1","3","3","0","7"
201819,"Broxtowe","LADU","Total","249","36","86","25","8","404"
201819,"Broxtowe","LADU","Level 3","246","33","82","22","7","390"
201819,"Broxtowe","LADU","Level 2","3","2","4","1","0","10"
201819,"Broxtowe","LADU","All other qualifications","0","1","0","2","1","4"
201920,"Broxtowe","LADU","Total","201","41","69","31","11","353"
201920,"Broxtowe","LADU","Level 3","199","34","60","29","11","333"
201920,"Broxtowe","LADU","Level 2","0","4","2","0","0","6"
201920,"Broxtowe","LADU","All other qualifications","2","3","7","2","0","14"
202021,"Broxtowe","LADU","Total","228","20","81","33","12","374"
202021,"Broxtowe","LADU","Level 3","224","15","76","27","10","352"
202021,"Broxtowe","LADU","Level 2","1","1","1","4","0","7"
202021,"Broxtowe","LADU","All other qualifications","3","4","4","2","2","15"
201718,"Charnwood","LADU","Total","798","222","488","236","91","1835"
201718,"Charnwood","LADU","Level 3","711","136","343","108","49","1347"
201718,"Charnwood","LADU","Level 2","64","57","91","45","14","271"
201718,"Charnwood","LADU","All other qualifications","23","29","54","83","28","217"
201819,"Charnwood","LADU","Total","862","216","590","279","102","2049"
201819,"Charnwood","LADU","Level 3","753","101","357","122","54","1387"
201819,"Charnwood","LADU","Level 2","85","89","170","95","24","463"
201819,"Charnwood","LADU","All other qualifications","24","26","63","62","24","199"
201920,"Charnwood","LADU","Total","1086","218","617","276","146","2343"
201920,"Charnwood","LADU","Level 3","985","128","426","143","96","1778"
201920,"Charnwood","LADU","Level 2","75","61","124","70","20","350"
201920,"Charnwood","LADU","All other qualifications","26","29","67","63","30","215"
202021,"Charnwood","LADU","Total","1153","178","608","324","120","2383"
202021,"Charnwood","LADU","Level 3","1003","92","429","186","82","1792"
202021,"Charnwood","LADU","Level 2","102","43","102","73","20","340"
202021,"Charnwood","LADU","All other qualifications","48","43","77","65","18","251"
201718,"Chesterfield","LADU","Total","975","361","693","311","116","2456"
201718,"Chesterfield","LADU","Level 3","782","132","345","99","46","1404"
201718,"Chesterfield","LADU","Level 2","130","150","270","95","21","666"
201718,"Chesterfield","LADU","All other qualifications","63","79","78","117","49","386"
201819,"Chesterfield","LADU","Total","585","264","575","244","89","1757"
201819,"Chesterfield","LADU","Level 3","523","82","266","87","35","993"
201819,"Chesterfield","LADU","Level 2","40","117","227","75","26","485"
201819,"Chesterfield","LADU","All other qualifications","22","65","82","82","28","279"
201920,"Chesterfield","LADU","Total","656","263","575","330","62","1886"
201920,"Chesterfield","LADU","Level 3","562","67","302","107","21","1059"
201920,"Chesterfield","LADU","Level 2","51","109","175","107","17","459"
201920,"Chesterfield","LADU","All other qualifications","43","87","98","116","24","368"
202021,"Chesterfield","LADU","Total","911","280","472","324","61","2048"
202021,"Chesterfield","LADU","Level 3","641","84","210","95","23","1053"
202021,"Chesterfield","LADU","Level 2","154","115","163","99","17","548"
202021,"Chesterfield","LADU","All other qualifications","116","81","99","130","21","447"
201718,"Corby","LADU","Total","178","24","50","19","7","278"
201718,"Corby","LADU","Level 3","177","20","48","18","6","269"
201718,"Corby","LADU","Level 2","0","2","2","0","0","4"
201718,"Corby","LADU","All other qualifications","1","2","0","1","1","5"
201819,"Corby","LADU","Total","158","22","73","12","10","275"
201819,"Corby","LADU","Level 3","156","20","71","9","10","266"
201819,"Corby","LADU","Level 2","0","0","1","1","0","2"
201819,"Corby","LADU","All other qualifications","2","2","1","2","0","7"
201920,"Corby","LADU","Total","208","18","55","19","8","308"
201920,"Corby","LADU","Level 3","207","18","55","17","7","304"
201920,"Corby","LADU","All other qualifications","1","0","0","2","1","4"
202021,"Corby","LADU","Total","212","15","58","16","10","311"
202021,"Corby","LADU","Level 3","203","11","52","16","10","292"
202021,"Corby","LADU","Level 2","2","1","0","0","0","3"
202021,"Corby","LADU","All other qualifications","7","3","6","0","0","16"
201718,"Daventry","LADU","Total","371","123","437","192","71","1194"
201718,"Daventry","LADU","Level 3","256","50","237","63","22","628"
201718,"Daventry","LADU","Level 2","95","37","127","73","21","353"
201718,"Daventry","LADU","All other qualifications","20","36","73","56","28","213"
201819,"Daventry","LADU","Total","344","120","411","176","68","1119"
201819,"Daventry","LADU","Level 3","231","34","205","56","26","552"
201819,"Daventry","LADU","Level 2","88","35","132","58","21","334"
201819,"Daventry","LADU","All other qualifications","25","51","74","62","21","233"
201920,"Daventry","LADU","Total","361","99","425","192","90","1167"
201920,"Daventry","LADU","Level 3","248","28","217","66","26","585"
201920,"Daventry","LADU","Level 2","85","22","108","52","31","298"
201920,"Daventry","LADU","All other qualifications","28","49","100","74","33","284"
202021,"Daventry","LADU","Total","352","72","357","171","56","1008"
202021,"Daventry","LADU","Level 3","267","17","168","54","19","525"
202021,"Daventry","LADU","Level 2","57","17","99","34","12","219"
202021,"Daventry","LADU","All other qualifications","28","38","90","83","25","264"
201718,"Derby","LADU","Total","1329","497","893","479","196","3394"
201718,"Derby","LADU","Level 3","988","242","443","134","63","1870"
201718,"Derby","LADU","Level 2","223","152","282","155","56","868"
201718,"Derby","LADU","All other qualifications","118","103","168","190","77","656"
201819,"Derby","LADU","Total","1259","529","920","471","189","3368"
201819,"Derby","LADU","Level 3","912","158","346","125","53","1594"
201819,"Derby","LADU","Level 2","222","257","389","174","67","1109"
201819,"Derby","LADU","All other qualifications","125","114","185","172","69","665"
201920,"Derby","LADU","Total","1466","458","900","560","194","3578"
201920,"Derby","LADU","Level 3","1088","188","418","128","52","1874"
201920,"Derby","LADU","Level 2","220","161","273","197","60","911"
201920,"Derby","LADU","All other qualifications","158","109","209","235","82","793"
202021,"Derby","LADU","Total","1485","393","793","566","157","3394"
202021,"Derby","LADU","Level 3","1029","134","302","157","39","1661"
202021,"Derby","LADU","Level 2","285","145","285","179","38","932"
202021,"Derby","LADU","All other qualifications","171","114","206","230","80","801"
201718,"Derbyshire Dales","LADU","Total","296","28","75","21","37","457"
201718,"Derbyshire Dales","LADU","Level 3","295","28","72","21","13","429"
201718,"Derbyshire Dales","LADU","Level 2","1","0","1","0","0","2"
201718,"Derbyshire Dales","LADU","All other qualifications","0","0","2","0","24","26"
201819,"Derbyshire Dales","LADU","Total","288","34","66","37","11","436"
201819,"Derbyshire Dales","LADU","Level 3","286","33","66","37","10","432"
201819,"Derbyshire Dales","LADU","Level 2","2","1","0","0","0","3"
201819,"Derbyshire Dales","LADU","All other qualifications","0","0","0","0","1","1"
201920,"Derbyshire Dales","LADU","Total","282","21","77","25","9","414"
201920,"Derbyshire Dales","LADU","Level 3","277","21","73","24","8","403"
201920,"Derbyshire Dales","LADU","Level 2","1","0","0","0","1","2"
201920,"Derbyshire Dales","LADU","All other qualifications","4","0","4","1","0","9"
202021,"Derbyshire Dales","LADU","Total","255","27","78","39","14","413"
202021,"Derbyshire Dales","LADU","Level 3","253","21","75","33","11","393"
202021,"Derbyshire Dales","LADU","Level 2","0","1","2","2","2","7"
202021,"Derbyshire Dales","LADU","All other qualifications","2","5","1","4","1","13"
201718,"East Lindsey","LADU","Total","333","31","99","55","23","541"
201718,"East Lindsey","LADU","Level 3","325","24","93","45","21","508"
201718,"East Lindsey","LADU","Level 2","6","3","2","6","2","19"
201718,"East Lindsey","LADU","All other qualifications","2","4","4","4","0","14"
201819,"East Lindsey","LADU","Total","281","27","77","48","14","447"
201819,"East Lindsey","LADU","Level 3","278","23","69","41","12","423"
201819,"East Lindsey","LADU","Level 2","0","2","6","6","0","14"
201819,"East Lindsey","LADU","All other qualifications","3","2","2","1","2","10"
201920,"East Lindsey","LADU","Total","258","21","52","36","7","374"
201920,"East Lindsey","LADU","Level 3","253","17","47","26","6","349"
201920,"East Lindsey","LADU","Level 2","2","1","2","3","1","9"
201920,"East Lindsey","LADU","All other qualifications","3","3","3","7","0","16"
202021,"East Lindsey","LADU","Total","254","12","36","23","10","335"
202021,"East Lindsey","LADU","Level 3","252","9","33","20","9","323"
202021,"East Lindsey","LADU","Level 2","1","0","3","3","1","8"
202021,"East Lindsey","LADU","All other qualifications","1","3","0","0","0","4"
201718,"East Northamptonshire","LADU","Total","153","27","82","22","16","300"
201718,"East Northamptonshire","LADU","Level 3","153","24","76","18","10","281"
201718,"East Northamptonshire","LADU","Level 2","0","3","4","3","5","15"
201718,"East Northamptonshire","LADU","All other qualifications","0","0","2","1","1","4"
201819,"East Northamptonshire","LADU","Total","170","29","90","25","8","322"
201819,"East Northamptonshire","LADU","Level 3","163","20","75","22","5","285"
201819,"East Northamptonshire","LADU","Level 2","7","7","15","3","2","34"
201819,"East Northamptonshire","LADU","All other qualifications","0","2","0","0","1","3"
201920,"East Northamptonshire","LADU","Total","149","24","117","17","11","318"
201920,"East Northamptonshire","LADU","Level 3","145","18","87","13","9","272"
201920,"East Northamptonshire","LADU","Level 2","2","4","20","3","1","30"
201920,"East Northamptonshire","LADU","All other qualifications","2","2","10","1","1","16"
202021,"East Northamptonshire","LADU","Total","185","17","98","26","17","343"
202021,"East Northamptonshire","LADU","Level 3","174","12","77","18","12","293"
202021,"East Northamptonshire","LADU","Level 2","5","2","14","7","1","29"
202021,"East Northamptonshire","LADU","All other qualifications","6","3","7","1","4","21"
201718,"Erewash","LADU","Total","148","60","63","28","19","318"
201718,"Erewash","LADU","Level 3","147","50","56","21","16","290"
201718,"Erewash","LADU","Level 2","1","7","6","6","2","22"
201718,"Erewash","LADU","All other qualifications","0","3","1","1","1","6"
201819,"Erewash","LADU","Total","127","40","78","19","12","276"
201819,"Erewash","LADU","Level 3","126","36","73","15","12","262"
201819,"Erewash","LADU","Level 2","1","2","3","3","0","9"
201819,"Erewash","LADU","All other qualifications","0","2","2","1","0","5"
201920,"Erewash","LADU","Total","119","42","65","18","4","248"
201920,"Erewash","LADU","Level 3","118","29","59","14","4","224"
201920,"Erewash","LADU","Level 2","0","6","3","0","0","9"
201920,"Erewash","LADU","All other qualifications","1","7","3","4","0","15"
202021,"Erewash","LADU","Total","132","30","59","20","9","250"
202021,"Erewash","LADU","Level 3","124","24","51","13","8","220"
202021,"Erewash","LADU","Level 2","4","2","5","4","1","16"
202021,"Erewash","LADU","All other qualifications","4","4","3","3","0","14"
201718,"Gedling","LADU","Total","305","39","92","34","15","485"
201718,"Gedling","LADU","Level 3","305","36","89","32","14","476"
201718,"Gedling","LADU","Level 2","0","3","2","1","0","6"
201718,"Gedling","LADU","All other qualifications","0","0","1","1","1","3"
201819,"Gedling","LADU","Total","312","37","87","27","10","473"
201819,"Gedling","LADU","Level 3","310","34","85","26","10","465"
201819,"Gedling","LADU","Level 2","0","1","0","0","0","1"
201819,"Gedling","LADU","All other qualifications","2","2","2","1","0","7"
201920,"Gedling","LADU","Total","304","41","67","34","18","464"
201920,"Gedling","LADU","Level 3","302","35","65","31","17","450"
201920,"Gedling","LADU","Level 2","1","1","0","1","0","3"
201920,"Gedling","LADU","All other qualifications","1","5","2","2","1","11"
202021,"Gedling","LADU","Total","364","29","85","44","18","540"
202021,"Gedling","LADU","Level 3","356","21","79","36","16","508"
202021,"Gedling","LADU","Level 2","2","2","1","1","0","6"
202021,"Gedling","LADU","All other qualifications","6","6","5","7","2","26"
201718,"Harborough","LADU","Total","299","47","98","27","15","486"
201718,"Harborough","LADU","Level 3","297","39","90","26","14","466"
201718,"Harborough","LADU","Level 2","2","6","7","0","1","16"
201718,"Harborough","LADU","All other qualifications","0","2","1","1","0","4"
201819,"Harborough","LADU","Total","272","57","102","28","24","483"
201819,"Harborough","LADU","Level 3","271","50","94","24","21","460"
201819,"Harborough","LADU","Level 2","1","3","8","4","1","17"
201819,"Harborough","LADU","All other qualifications","0","4","0","0","2","6"
201920,"Harborough","LADU","Total","216","31","99","30","12","388"
201920,"Harborough","LADU","Level 3","211","21","93","24","9","358"
201920,"Harborough","LADU","Level 2","4","5","4","1","1","15"
201920,"Harborough","LADU","All other qualifications","1","5","2","5","2","15"
202021,"Harborough","LADU","Total","159","20","63","32","14","288"
202021,"Harborough","LADU","Level 3","153","10","58","24","10","255"
202021,"Harborough","LADU","Level 2","6","5","3","4","0","18"
202021,"Harborough","LADU","All other qualifications","0","5","2","4","4","15"
201718,"High Peak","LADU","Total","108","19","41","13","4","185"
201718,"High Peak","LADU","Level 3","103","18","41","12","4","178"
201718,"High Peak","LADU","Level 2","3","1","0","1","0","5"
201718,"High Peak","LADU","All other qualifications","2","0","0","0","0","2"
201819,"High Peak","LADU","Total","109","20","37","7","13","186"
201819,"High Peak","LADU","Level 3","99","16","35","6","12","168"
201819,"High Peak","LADU","Level 2","2","2","1","0","1","6"
201819,"High Peak","LADU","All other qualifications","8","2","1","1","0","12"
201920,"High Peak","LADU","Total","88","10","33","11","7","149"
201920,"High Peak","LADU","Level 3","80","8","29","7","7","131"
201920,"High Peak","LADU","Level 2","3","1","0","2","0","6"
201920,"High Peak","LADU","All other qualifications","5","1","4","2","0","12"
202021,"High Peak","LADU","Total","97","8","26","14","5","150"
202021,"High Peak","LADU","Level 3","85","4","23","12","5","129"
202021,"High Peak","LADU","Level 2","1","0","0","0","0","1"
202021,"High Peak","LADU","All other qualifications","11","4","3","2","0","20"
201718,"Hinckley and Bosworth","LADU","Total","449","76","180","44","25","774"
201718,"Hinckley and Bosworth","LADU","Level 3","448","65","163","37","24","737"
201718,"Hinckley and Bosworth","LADU","Level 2","0","5","10","3","1","19"
201718,"Hinckley and Bosworth","LADU","All other qualifications","1","6","7","4","0","18"
201819,"Hinckley and Bosworth","LADU","Total","339","57","144","35","10","585"
201819,"Hinckley and Bosworth","LADU","Level 3","339","47","128","29","7","550"
201819,"Hinckley and Bosworth","LADU","Level 2","0","7","11","3","2","23"
201819,"Hinckley and Bosworth","LADU","All other qualifications","0","3","5","3","1","12"
201920,"Hinckley and Bosworth","LADU","Total","342","53","121","40","18","574"
201920,"Hinckley and Bosworth","LADU","Level 3","336","45","111","32","14","538"
201920,"Hinckley and Bosworth","LADU","Level 2","5","4","3","3","2","17"
201920,"Hinckley and Bosworth","LADU","All other qualifications","1","4","7","5","2","19"
202021,"Hinckley and Bosworth","LADU","Total","306","31","89","35","11","472"
202021,"Hinckley and Bosworth","LADU","Level 3","301","23","81","32","10","447"
202021,"Hinckley and Bosworth","LADU","Level 2","3","4","4","1","0","12"
202021,"Hinckley and Bosworth","LADU","All other qualifications","2","4","4","2","1","13"
201718,"Kettering","LADU","Total","740","228","550","287","91","1896"
201718,"Kettering","LADU","Level 3","590","78","243","75","21","1007"
201718,"Kettering","LADU","Level 2","80","87","160","70","21","418"
201718,"Kettering","LADU","All other qualifications","70","63","147","142","49","471"
201819,"Kettering","LADU","Total","340","159","279","136","77","991"
201819,"Kettering","LADU","Level 3","330","49","128","33","13","553"
201819,"Kettering","LADU","Level 2","5","53","65","24","19","166"
201819,"Kettering","LADU","All other qualifications","5","57","86","79","45","272"
201920,"Kettering","LADU","Total","321","104","250","124","96","895"
201920,"Kettering","LADU","Level 3","314","32","117","31","16","510"
201920,"Kettering","LADU","Level 2","2","32","69","32","13","148"
201920,"Kettering","LADU","All other qualifications","5","40","64","61","67","237"
202021,"Kettering","LADU","Total","366","31","107","36","20","560"
202021,"Kettering","LADU","Level 3","363","21","80","30","13","507"
202021,"Kettering","LADU","Level 2","0","2","15","2","6","25"
202021,"Kettering","LADU","All other qualifications","3","8","12","4","1","28"
201718,"Leicester","LADU","Total","2073","349","901","582","255","4160"
201718,"Leicester","LADU","Level 3","1751","144","464","252","104","2715"
201718,"Leicester","LADU","Level 2","201","123","231","135","44","734"
201718,"Leicester","LADU","All other qualifications","121","82","206","195","107","711"
201819,"Leicester","LADU","Total","2178","330","963","575","281","4327"
201819,"Leicester","LADU","Level 3","1643","134","424","212","111","2524"
201819,"Leicester","LADU","Level 2","398","126","327","187","74","1112"
201819,"Leicester","LADU","All other qualifications","137","70","212","176","96","691"
201920,"Leicester","LADU","Total","2058","300","865","615","269","4107"
201920,"Leicester","LADU","Level 3","1766","116","433","243","112","2670"
201920,"Leicester","LADU","Level 2","138","108","210","149","56","661"
201920,"Leicester","LADU","All other qualifications","154","76","222","223","101","776"
202021,"Leicester","LADU","Total","2494","260","909","793","290","4746"
202021,"Leicester","LADU","Level 3","1863","82","477","330","126","2878"
202021,"Leicester","LADU","Level 2","388","98","220","186","55","947"
202021,"Leicester","LADU","All other qualifications","243","80","212","277","109","921"
201718,"Lincoln","LADU","Total","643","243","567","270","148","1871"
201718,"Lincoln","LADU","Level 3","587","99","309","84","65","1144"
201718,"Lincoln","LADU","Level 2","40","70","148","77","38","373"
201718,"Lincoln","LADU","All other qualifications","16","74","110","109","45","354"
201819,"Lincoln","LADU","Total","749","377","640","347","146","2259"
201819,"Lincoln","LADU","Level 3","561","118","266","85","58","1088"
201819,"Lincoln","LADU","Level 2","118","171","252","133","41","715"
201819,"Lincoln","LADU","All other qualifications","70","88","122","129","47","456"
201920,"Lincoln","LADU","Total","749","308","582","333","102","2074"
201920,"Lincoln","LADU","Level 3","605","93","312","105","46","1161"
201920,"Lincoln","LADU","Level 2","81","140","168","105","29","523"
201920,"Lincoln","LADU","All other qualifications","63","75","102","123","27","390"
202021,"Lincoln","LADU","Total","897","193","507","315","104","2016"
202021,"Lincoln","LADU","Level 3","697","52","254","99","51","1153"
202021,"Lincoln","LADU","Level 2","144","75","165","109","28","521"
202021,"Lincoln","LADU","All other qualifications","56","66","88","107","25","342"
201718,"Mansfield","LADU","Total","619","251","491","252","87","1700"
201718,"Mansfield","LADU","Level 3","439","99","264","68","34","904"
201718,"Mansfield","LADU","Level 2","106","77","127","60","19","389"
201718,"Mansfield","LADU","All other qualifications","74","75","100","124","34","407"
201819,"Mansfield","LADU","Total","660","244","438","275","66","1683"
201819,"Mansfield","LADU","Level 3","453","81","197","66","25","822"
201819,"Mansfield","LADU","Level 2","131","99","141","80","18","469"
201819,"Mansfield","LADU","All other qualifications","76","64","100","129","23","392"
201920,"Mansfield","LADU","Total","646","239","528","316","74","1803"
201920,"Mansfield","LADU","Level 3","469","80","244","85","19","897"
201920,"Mansfield","LADU","Level 2","103","77","156","89","15","440"
201920,"Mansfield","LADU","All other qualifications","74","82","128","142","40","466"
202021,"Mansfield","LADU","Total","686","181","465","335","61","1728"
202021,"Mansfield","LADU","Level 3","479","56","225","81","25","866"
202021,"Mansfield","LADU","Level 2","112","68","109","100","12","401"
202021,"Mansfield","LADU","All other qualifications","95","57","131","154","24","461"
201718,"Melton","LADU","Total","258","80","252","89","51","730"
201718,"Melton","LADU","Level 3","230","42","182","38","28","520"
201718,"Melton","LADU","Level 2","17","14","41","15","6","93"
201718,"Melton","LADU","All other qualifications","11","24","29","36","17","117"
201819,"Melton","LADU","Total","295","82","239","95","32","743"
201819,"Melton","LADU","Level 3","241","31","152","36","18","478"
201819,"Melton","LADU","Level 2","41","31","64","30","5","171"
201819,"Melton","LADU","All other qualifications","13","20","23","29","9","94"
201920,"Melton","LADU","Total","245","67","258","108","44","722"
201920,"Melton","LADU","Level 3","212","35","171","47","14","479"
201920,"Melton","LADU","Level 2","15","22","47","28","6","118"
201920,"Melton","LADU","All other qualifications","18","10","40","33","24","125"
202021,"Melton","LADU","Total","139","13","47","14","7","220"
202021,"Melton","LADU","Level 3","136","7","43","11","6","203"
202021,"Melton","LADU","Level 2","0","1","0","0","0","1"
202021,"Melton","LADU","All other qualifications","3","5","4","3","1","16"
201718,"Newark and Sherwood","LADU","Total","184","23","88","33","14","342"
201718,"Newark and Sherwood","LADU","Level 3","184","22","85","28","13","332"
201718,"Newark and Sherwood","LADU","Level 2","0","0","3","3","1","7"
201718,"Newark and Sherwood","LADU","All other qualifications","0","1","0","2","0","3"
201819,"Newark and Sherwood","LADU","Total","210","22","82","23","8","345"
201819,"Newark and Sherwood","LADU","Level 3","209","20","81","18","7","335"
201819,"Newark and Sherwood","LADU","Level 2","1","2","1","3","1","8"
201819,"Newark and Sherwood","LADU","All other qualifications","0","0","0","2","0","2"
201920,"Newark and Sherwood","LADU","Total","164","28","73","21","14","300"
201920,"Newark and Sherwood","LADU","Level 3","163","23","70","18","14","288"
201920,"Newark and Sherwood","LADU","Level 2","0","1","3","1","0","5"
201920,"Newark and Sherwood","LADU","All other qualifications","1","4","0","2","0","7"
202021,"Newark and Sherwood","LADU","Total","238","13","60","35","8","354"
202021,"Newark and Sherwood","LADU","Level 3","235","8","56","32","6","337"
202021,"Newark and Sherwood","LADU","Level 2","0","2","0","1","1","4"
202021,"Newark and Sherwood","LADU","All other qualifications","3","3","4","2","1","13"
201718,"North East Derbyshire","LADU","Total","205","36","68","19","11","339"
201718,"North East Derbyshire","LADU","Level 3","205","29","67","17","10","328"
201718,"North East Derbyshire","LADU","Level 2","0","1","0","1","1","3"
201718,"North East Derbyshire","LADU","All other qualifications","0","6","1","1","0","8"
201819,"North East Derbyshire","LADU","Total","224","38","69","26","8","365"
201819,"North East Derbyshire","LADU","Level 3","224","34","65","25","7","355"
201819,"North East Derbyshire","LADU","Level 2","0","0","2","0","1","3"
201819,"North East Derbyshire","LADU","All other qualifications","0","4","2","1","0","7"
201920,"North East Derbyshire","LADU","Total","209","30","69","29","12","349"
201920,"North East Derbyshire","LADU","Level 3","205","27","65","25","11","333"
201920,"North East Derbyshire","LADU","Level 2","2","0","0","0","0","2"
201920,"North East Derbyshire","LADU","All other qualifications","2","3","4","4","1","14"
202021,"North East Derbyshire","LADU","Total","229","24","57","23","9","342"
202021,"North East Derbyshire","LADU","Level 3","228","20","53","23","9","333"
202021,"North East Derbyshire","LADU","Level 2","0","1","0","0","0","1"
202021,"North East Derbyshire","LADU","All other qualifications","1","3","4","0","0","8"
201718,"North Kesteven","LADU","Total","431","73","166","38","23","731"
201718,"North Kesteven","LADU","Level 3","424","61","147","34","21","687"
201718,"North Kesteven","LADU","Level 2","7","9","17","2","1","36"
201718,"North Kesteven","LADU","All other qualifications","0","3","2","2","1","8"
201819,"North Kesteven","LADU","Total","441","71","154","56","16","738"
201819,"North Kesteven","LADU","Level 3","437","63","133","44","16","693"
201819,"North Kesteven","LADU","Level 2","4","4","19","9","0","36"
201819,"North Kesteven","LADU","All other qualifications","0","4","2","3","0","9"
201920,"North Kesteven","LADU","Total","381","66","130","48","20","645"
201920,"North Kesteven","LADU","Level 3","370","48","110","37","15","580"
201920,"North Kesteven","LADU","Level 2","8","11","15","8","4","46"
201920,"North Kesteven","LADU","All other qualifications","3","7","5","3","1","19"
202021,"North Kesteven","LADU","Total","382","51","107","51","22","613"
202021,"North Kesteven","LADU","Level 3","364","33","96","35","16","544"
202021,"North Kesteven","LADU","Level 2","11","10","3","9","3","36"
202021,"North Kesteven","LADU","All other qualifications","7","8","8","7","3","33"
201718,"North West Leicestershire","LADU","Total","315","215","263","127","42","962"
201718,"North West Leicestershire","LADU","Level 3","287","61","120","33","17","518"
201718,"North West Leicestershire","LADU","Level 2","23","92","87","35","8","245"
201718,"North West Leicestershire","LADU","All other qualifications","5","62","56","59","17","199"
201819,"North West Leicestershire","LADU","Total","328","140","245","106","32","851"
201819,"North West Leicestershire","LADU","Level 3","286","37","95","24","15","457"
201819,"North West Leicestershire","LADU","Level 2","31","63","105","40","8","247"
201819,"North West Leicestershire","LADU","All other qualifications","11","40","45","42","9","147"
201920,"North West Leicestershire","LADU","Total","291","147","209","95","34","776"
201920,"North West Leicestershire","LADU","Level 3","261","50","114","32","15","472"
201920,"North West Leicestershire","LADU","Level 2","19","56","59","27","7","168"
201920,"North West Leicestershire","LADU","All other qualifications","11","41","36","36","12","136"
202021,"North West Leicestershire","LADU","Total","519","175","367","203","91","1355"
202021,"North West Leicestershire","LADU","Level 3","404","49","203","93","43","792"
202021,"North West Leicestershire","LADU","Level 2","64","58","97","53","24","296"
202021,"North West Leicestershire","LADU","All other qualifications","51","68","67","57","24","267"
201718,"Northampton","LADU","Total","1157","284","793","374","142","2750"
201718,"Northampton","LADU","Level 3","859","137","448","143","52","1639"
201718,"Northampton","LADU","Level 2","181","86","185","92","37","581"
201718,"Northampton","LADU","All other qualifications","117","61","160","139","53","530"
201819,"Northampton","LADU","Total","1146","255","749","390","129","2669"
201819,"Northampton","LADU","Level 3","872","101","391","139","35","1538"
201819,"Northampton","LADU","Level 2","186","93","220","103","38","640"
201819,"Northampton","LADU","All other qualifications","88","61","138","148","56","491"
201920,"Northampton","LADU","Total","1229","219","714","329","123","2614"
201920,"Northampton","LADU","Level 3","954","85","389","120","43","1591"
201920,"Northampton","LADU","Level 2","171","88","188","95","21","563"
201920,"Northampton","LADU","All other qualifications","104","46","137","114","59","460"
202021,"Northampton","LADU","Total","1329","216","721","401","97","2764"
202021,"Northampton","LADU","Level 3","1038","83","408","156","46","1731"
202021,"Northampton","LADU","Level 2","179","84","173","98","16","550"
202021,"Northampton","LADU","All other qualifications","112","49","140","147","35","483"
201718,"Nottingham","LADU","Total","2099","527","1273","794","328","5021"
201718,"Nottingham","LADU","Level 3","1579","191","650","269","126","2815"
201718,"Nottingham","LADU","Level 2","278","176","324","211","59","1048"
201718,"Nottingham","LADU","All other qualifications","242","160","299","314","143","1158"
201819,"Nottingham","LADU","Total","1772","487","1219","787","294","4559"
201819,"Nottingham","LADU","Level 3","1283","154","577","225","101","2340"
201819,"Nottingham","LADU","Level 2","230","168","344","214","62","1018"
201819,"Nottingham","LADU","All other qualifications","259","165","298","348","131","1201"
201920,"Nottingham","LADU","Total","2232","469","1264","868","266","5099"
201920,"Nottingham","LADU","Level 3","1484","161","655","267","116","2683"
201920,"Nottingham","LADU","Level 2","440","153","319","237","47","1196"
201920,"Nottingham","LADU","All other qualifications","308","155","290","364","103","1220"
202021,"Nottingham","LADU","Total","2180","348","975","797","228","4528"
202021,"Nottingham","LADU","Level 3","1527","96","462","215","80","2380"
202021,"Nottingham","LADU","Level 2","353","119","262","210","45","989"
202021,"Nottingham","LADU","All other qualifications","300","133","251","372","103","1159"
201718,"Oadby and Wigston","LADU","Total","350","96","165","94","42","747"
201718,"Oadby and Wigston","LADU","Level 3","345","49","113","48","23","578"
201718,"Oadby and Wigston","LADU","Level 2","3","19","21","9","6","58"
201718,"Oadby and Wigston","LADU","All other qualifications","2","28","31","37","13","111"
201819,"Oadby and Wigston","LADU","Total","390","60","133","66","50","699"
201819,"Oadby and Wigston","LADU","Level 3","377","37","113","40","36","603"
201819,"Oadby and Wigston","LADU","Level 2","13","14","11","12","5","55"
201819,"Oadby and Wigston","LADU","All other qualifications","0","9","9","14","9","41"
201920,"Oadby and Wigston","LADU","Total","367","37","90","43","30","567"
201920,"Oadby and Wigston","LADU","Level 3","359","29","77","37","27","529"
201920,"Oadby and Wigston","LADU","Level 2","7","5","9","2","2","25"
201920,"Oadby and Wigston","LADU","All other qualifications","1","3","4","4","1","13"
202021,"Oadby and Wigston","LADU","Total","363","20","78","45","27","533"
202021,"Oadby and Wigston","LADU","Level 3","356","13","73","41","24","507"
202021,"Oadby and Wigston","LADU","Level 2","5","6","2","2","0","15"
202021,"Oadby and Wigston","LADU","All other qualifications","2","1","3","2","3","11"
201718,"Rushcliffe","LADU","Total","564","32","155","53","20","824"
201718,"Rushcliffe","LADU","Level 3","563","28","153","47","19","810"
201718,"Rushcliffe","LADU","Level 2","1","2","1","1","0","5"
201718,"Rushcliffe","LADU","All other qualifications","0","2","1","5","1","9"
201819,"Rushcliffe","LADU","Total","516","42","179","57","23","817"
201819,"Rushcliffe","LADU","Level 3","515","40","178","51","22","806"
201819,"Rushcliffe","LADU","Level 2","1","0","1","2","0","4"
201819,"Rushcliffe","LADU","All other qualifications","0","2","0","4","1","7"
201920,"Rushcliffe","LADU","Total","547","33","145","66","29","820"
201920,"Rushcliffe","LADU","Level 3","531","29","141","62","29","792"
201920,"Rushcliffe","LADU","Level 2","0","1","1","1","0","3"
201920,"Rushcliffe","LADU","All other qualifications","16","3","3","3","0","25"
202021,"Rushcliffe","LADU","Total","624","36","126","56","35","877"
202021,"Rushcliffe","LADU","Level 3","597","28","115","50","33","823"
202021,"Rushcliffe","LADU","Level 2","1","0","2","2","0","5"
202021,"Rushcliffe","LADU","All other qualifications","26","8","9","4","2","49"
201718,"Rutland","LADU","Total","70","12","35","9","5","131"
201718,"Rutland","LADU","Level 3","65","8","32","7","3","115"
201718,"Rutland","LADU","Level 2","1","4","3","0","0","8"
201718,"Rutland","LADU","All other qualifications","4","0","0","2","2","8"
201819,"Rutland","LADU","Total","59","4","13","7","0","83"
201819,"Rutland","LADU","Level 3","58","4","13","7","0","82"
201819,"Rutland","LADU","All other qualifications","1","0","0","0","0","1"
201920,"Rutland","LADU","Total","71","4","21","9","2","107"
201920,"Rutland","LADU","Level 3","70","4","18","7","2","101"
201920,"Rutland","LADU","Level 2","0","0","3","1","0","4"
201920,"Rutland","LADU","All other qualifications","1","0","0","1","0","2"
202021,"Rutland","LADU","Total","96","5","25","6","2","134"
202021,"Rutland","LADU","Level 3","96","4","24","4","1","129"
202021,"Rutland","LADU","Level 2","0","0","1","0","0","1"
202021,"Rutland","LADU","All other qualifications","0","1","0","2","1","4"
201718,"South Derbyshire","LADU","Total","150","37","39","10","1","237"
201718,"South Derbyshire","LADU","Level 3","150","34","39","10","1","234"
201718,"South Derbyshire","LADU","Level 2","0","1","0","0","0","1"
201718,"South Derbyshire","LADU","All other qualifications","0","2","0","0","0","2"
201819,"South Derbyshire","LADU","Total","124","18","34","11","0","187"
201819,"South Derbyshire","LADU","Level 3","124","18","33","8","0","183"
201819,"South Derbyshire","LADU","Level 2","0","0","1","1","0","2"
201819,"South Derbyshire","LADU","All other qualifications","0","0","0","2","0","2"
201920,"South Derbyshire","LADU","Total","114","24","40","13","6","197"
201920,"South Derbyshire","LADU","Level 3","113","22","34","11","5","185"
201920,"South Derbyshire","LADU","Level 2","0","0","1","1","0","2"
201920,"South Derbyshire","LADU","All other qualifications","1","2","5","1","1","10"
202021,"South Derbyshire","LADU","Total","133","18","56","9","4","220"
202021,"South Derbyshire","LADU","Level 3","132","13","54","9","2","210"
202021,"South Derbyshire","LADU","Level 2","0","2","0","0","0","2"
202021,"South Derbyshire","LADU","All other qualifications","1","3","2","0","2","8"
201718,"South Holland","LADU","Total","235","47","95","38","15","430"
201718,"South Holland","LADU","Level 3","226","36","78","20","10","370"
201718,"South Holland","LADU","Level 2","5","8","14","13","2","42"
201718,"South Holland","LADU","All other qualifications","4","3","3","5","3","18"
201819,"South Holland","LADU","Total","230","53","86","30","16","415"
201819,"South Holland","LADU","Level 3","206","38","54","17","10","325"
201819,"South Holland","LADU","Level 2","15","13","25","12","4","69"
201819,"South Holland","LADU","All other qualifications","9","2","7","1","2","21"
201920,"South Holland","LADU","Total","228","40","71","26","7","372"
201920,"South Holland","LADU","Level 3","218","20","55","11","5","309"
201920,"South Holland","LADU","Level 2","4","15","13","6","2","40"
201920,"South Holland","LADU","All other qualifications","6","5","3","9","0","23"
202021,"South Holland","LADU","Total","220","40","84","40","12","396"
202021,"South Holland","LADU","Level 3","201","18","45","16","7","287"
202021,"South Holland","LADU","Level 2","16","20","29","16","4","85"
202021,"South Holland","LADU","All other qualifications","3","2","10","8","1","24"
201718,"South Kesteven","LADU","Total","958","187","552","238","94","2029"
201718,"South Kesteven","LADU","Level 3","851","102","343","97","51","1444"
201718,"South Kesteven","LADU","Level 2","59","48","114","56","13","290"
201718,"South Kesteven","LADU","All other qualifications","48","37","95","85","30","295"
201819,"South Kesteven","LADU","Total","1049","217","639","240","74","2219"
201819,"South Kesteven","LADU","Level 3","785","73","337","77","34","1306"
201819,"South Kesteven","LADU","Level 2","175","77","202","81","16","551"
201819,"South Kesteven","LADU","All other qualifications","89","67","100","82","24","362"
201920,"South Kesteven","LADU","Total","925","165","582","262","85","2019"
201920,"South Kesteven","LADU","Level 3","780","78","364","105","43","1370"
201920,"South Kesteven","LADU","Level 2","84","44","121","64","13","326"
201920,"South Kesteven","LADU","All other qualifications","61","43","97","93","29","323"
202021,"South Kesteven","LADU","Total","1058","169","540","313","96","2176"
202021,"South Kesteven","LADU","Level 3","830","82","350","129","56","1447"
202021,"South Kesteven","LADU","Level 2","110","42","102","73","10","337"
202021,"South Kesteven","LADU","All other qualifications","118","45","88","111","30","392"
201718,"South Northamptonshire","LADU","Total","427","67","203","62","22","781"
201718,"South Northamptonshire","LADU","Level 3","426","63","200","60","22","771"
201718,"South Northamptonshire","LADU","Level 2","1","4","2","0","0","7"
201718,"South Northamptonshire","LADU","All other qualifications","0","0","1","2","0","3"
201819,"South Northamptonshire","LADU","Total","410","71","206","52","15","754"
201819,"South Northamptonshire","LADU","Level 3","407","69","201","49","14","740"
201819,"South Northamptonshire","LADU","Level 2","3","0","1","1","0","5"
201819,"South Northamptonshire","LADU","All other qualifications","0","2","4","2","1","9"
201920,"South Northamptonshire","LADU","Total","400","62","177","42","18","699"
201920,"South Northamptonshire","LADU","Level 3","397","60","169","38","17","681"
201920,"South Northamptonshire","LADU","Level 2","3","0","2","0","0","5"
201920,"South Northamptonshire","LADU","All other qualifications","0","2","6","4","1","13"
202021,"South Northamptonshire","LADU","Total","424","40","159","35","25","683"
202021,"South Northamptonshire","LADU","Level 3","418","30","155","29","23","655"
202021,"South Northamptonshire","LADU","Level 2","4","3","0","1","0","8"
202021,"South Northamptonshire","LADU","All other qualifications","2","7","4","5","2","20"
201718,"Wellingborough","LADU","Total","198","30","75","25","7","335"
201718,"Wellingborough","LADU","Level 3","198","24","69","25","6","322"
201718,"Wellingborough","LADU","Level 2","0","5","2","0","0","7"
201718,"Wellingborough","LADU","All other qualifications","0","1","4","0","1","6"
201819,"Wellingborough","LADU","Total","193","23","65","23","10","314"
201819,"Wellingborough","LADU","Level 3","191","18","61","19","7","296"
201819,"Wellingborough","LADU","Level 2","2","1","2","4","1","10"
201819,"Wellingborough","LADU","All other qualifications","0","4","2","0","2","8"
201920,"Wellingborough","LADU","Total","177","21","57","18","6","279"
201920,"Wellingborough","LADU","Level 3","177","15","48","16","5","261"
201920,"Wellingborough","LADU","Level 2","0","2","1","0","0","3"
201920,"Wellingborough","LADU","All other qualifications","0","4","8","2","1","15"
202021,"Wellingborough","LADU","Total","204","23","56","19","5","307"
202021,"Wellingborough","LADU","Level 3","202","19","52","15","5","293"
202021,"Wellingborough","LADU","Level 2","0","0","0","2","0","2"
202021,"Wellingborough","LADU","All other qualifications","2","4","4","2","0","12"
201718,"West Lindsey","LADU","Total","338","19","41","23","20","441"
201718,"West Lindsey","LADU","Level 3","337","18","36","23","19","433"
201718,"West Lindsey","LADU","Level 2","1","1","4","0","1","7"
201718,"West Lindsey","LADU","All other qualifications","0","0","1","0","0","1"
201819,"West Lindsey","LADU","Total","317","12","52","28","15","424"
201819,"West Lindsey","LADU","Level 3","315","12","52","27","15","421"
201819,"West Lindsey","LADU","Level 2","2","0","0","0","0","2"
201819,"West Lindsey","LADU","All other qualifications","0","0","0","1","0","1"
201920,"West Lindsey","LADU","Total","310","24","54","24","15","427"
201920,"West Lindsey","LADU","Level 3","307","21","53","21","15","417"
201920,"West Lindsey","LADU","Level 2","1","0","1","1","0","3"
201920,"West Lindsey","LADU","All other qualifications","2","3","0","2","0","7"
202021,"West Lindsey","LADU","Total","278","16","51","17","11","373"
202021,"West Lindsey","LADU","Level 3","276","13","50","16","11","366"
202021,"West Lindsey","LADU","Level 2","1","0","0","1","0","2"
202021,"West Lindsey","LADU","All other qualifications","1","3","1","0","0","5"
201718,"Birmingham","LADU","Total","6364","820","2221","1765","981","12151"
201718,"Birmingham","LADU","Level 3","5524","424","1415","831","471","8665"
201718,"Birmingham","LADU","Level 2","504","194","392","363","180","1633"
201718,"Birmingham","LADU","All other qualifications","336","202","414","571","330","1853"
201819,"Birmingham","LADU","Total","6109","829","1894","1820","798","11450"
201819,"Birmingham","LADU","Level 3","4983","390","1057","750","354","7534"
201819,"Birmingham","LADU","Level 2","756","238","467","447","171","2079"
201819,"Birmingham","LADU","All other qualifications","370","201","370","623","273","1837"
201920,"Birmingham","LADU","Total","6250","692","1966","1776","743","11427"
201920,"Birmingham","LADU","Level 3","5265","324","1208","747","325","7869"
201920,"Birmingham","LADU","Level 2","611","193","409","415","117","1745"
201920,"Birmingham","LADU","All other qualifications","374","175","349","614","301","1813"
202021,"Birmingham","LADU","Total","6664","460","1395","2081","684","11284"
202021,"Birmingham","LADU","Level 3","5103","198","806","921","332","7360"
202021,"Birmingham","LADU","Level 2","971","114","261","510","115","1971"
202021,"Birmingham","LADU","All other qualifications","590","148","328","650","237","1953"
201718,"Bromsgrove","LADU","Total","386","64","122","45","19","636"
201718,"Bromsgrove","LADU","Level 3","384","61","119","41","19","624"
201718,"Bromsgrove","LADU","Level 2","1","0","3","0","0","4"
201718,"Bromsgrove","LADU","All other qualifications","1","3","0","4","0","8"
201819,"Bromsgrove","LADU","Total","339","48","142","44","22","595"
201819,"Bromsgrove","LADU","Level 3","338","47","140","44","22","591"
201819,"Bromsgrove","LADU","Level 2","1","0","2","0","0","3"
201819,"Bromsgrove","LADU","All other qualifications","0","1","0","0","0","1"
201920,"Bromsgrove","LADU","Total","298","37","136","49","25","545"
201920,"Bromsgrove","LADU","Level 3","293","32","133","47","22","527"
201920,"Bromsgrove","LADU","Level 2","1","1","0","0","0","2"
201920,"Bromsgrove","LADU","All other qualifications","4","4","3","2","3","16"
202021,"Bromsgrove","LADU","Total","339","32","102","43","19","535"
202021,"Bromsgrove","LADU","Level 3","337","24","100","42","17","520"
202021,"Bromsgrove","LADU","Level 2","0","0","0","1","1","2"
202021,"Bromsgrove","LADU","All other qualifications","2","8","2","0","1","13"
201718,"Cannock Chase","LADU","Total","470","185","505","262","100","1522"
201718,"Cannock Chase","LADU","Level 3","310","81","231","80","35","737"
201718,"Cannock Chase","LADU","Level 2","92","51","156","64","19","382"
201718,"Cannock Chase","LADU","All other qualifications","68","53","118","118","46","403"
201819,"Cannock Chase","LADU","Total","376","151","472","280","80","1359"
201819,"Cannock Chase","LADU","Level 3","292","62","212","87","24","677"
201819,"Cannock Chase","LADU","Level 2","50","58","141","82","23","354"
201819,"Cannock Chase","LADU","All other qualifications","34","31","119","111","33","328"
201920,"Cannock Chase","LADU","Total","172","45","42","20","8","287"
201920,"Cannock Chase","LADU","Level 3","170","34","36","17","5","262"
201920,"Cannock Chase","LADU","Level 2","0","4","2","2","1","9"
201920,"Cannock Chase","LADU","All other qualifications","2","7","4","1","2","16"
202021,"Cannock Chase","LADU","Total","155","28","44","31","7","265"
202021,"Cannock Chase","LADU","Level 3","152","21","40","24","5","242"
202021,"Cannock Chase","LADU","Level 2","2","2","1","3","0","8"
202021,"Cannock Chase","LADU","All other qualifications","1","5","3","4","2","15"
201718,"Coventry","LADU","Total","1555","343","663","421","193","3175"
201718,"Coventry","LADU","Level 3","1280","179","386","171","62","2078"
201718,"Coventry","LADU","Level 2","161","82","124","79","36","482"
201718,"Coventry","LADU","All other qualifications","114","82","153","171","95","615"
201819,"Coventry","LADU","Total","1530","331","717","443","172","3193"
201819,"Coventry","LADU","Level 3","1190","173","397","165","54","1979"
201819,"Coventry","LADU","Level 2","194","77","172","98","40","581"
201819,"Coventry","LADU","All other qualifications","146","81","148","180","78","633"
201920,"Coventry","LADU","Total","1561","252","638","396","157","3004"
201920,"Coventry","LADU","Level 3","1259","144","352","135","50","1940"
201920,"Coventry","LADU","Level 2","143","51","121","86","31","432"
201920,"Coventry","LADU","All other qualifications","159","57","165","175","76","632"
202021,"Coventry","LADU","Total","1706","186","525","504","171","3092"
202021,"Coventry","LADU","Level 3","1270","90","309","189","61","1919"
202021,"Coventry","LADU","Level 2","254","42","94","100","29","519"
202021,"Coventry","LADU","All other qualifications","182","54","122","215","81","654"
201718,"Dudley","LADU","Total","2034","629","1073","624","273","4633"
201718,"Dudley","LADU","Level 3","1844","287","657","271","124","3183"
201718,"Dudley","LADU","Level 2","108","194","268","139","51","760"
201718,"Dudley","LADU","All other qualifications","82","148","148","214","98","690"
201819,"Dudley","LADU","Total","2418","594","1068","747","261","5088"
201819,"Dudley","LADU","Level 3","1904","302","559","284","102","3151"
201819,"Dudley","LADU","Level 2","358","166","356","249","66","1195"
201819,"Dudley","LADU","All other qualifications","156","126","153","214","93","742"
201920,"Dudley","LADU","Total","2381","518","982","740","237","4858"
201920,"Dudley","LADU","Level 3","2050","278","643","310","96","3377"
201920,"Dudley","LADU","Level 2","193","141","183","177","39","733"
201920,"Dudley","LADU","All other qualifications","138","99","156","253","102","748"
202021,"Dudley","LADU","Total","2974","440","1008","1011","230","5663"
202021,"Dudley","LADU","Level 3","2406","182","641","465","108","3802"
202021,"Dudley","LADU","Level 2","310","128","174","220","32","864"
202021,"Dudley","LADU","All other qualifications","258","130","193","326","90","997"
201718,"East Staffordshire","LADU","Total","716","237","450","200","48","1651"
201718,"East Staffordshire","LADU","Level 3","572","124","248","68","19","1031"
201718,"East Staffordshire","LADU","Level 2","120","68","109","49","14","360"
201718,"East Staffordshire","LADU","All other qualifications","24","45","93","83","15","260"
201819,"East Staffordshire","LADU","Total","733","192","490","202","50","1667"
201819,"East Staffordshire","LADU","Level 3","557","78","272","77","21","1005"
201819,"East Staffordshire","LADU","Level 2","134","73","163","74","11","455"
201819,"East Staffordshire","LADU","All other qualifications","42","41","55","51","18","207"
201920,"East Staffordshire","LADU","Total","682","187","447","182","60","1558"
201920,"East Staffordshire","LADU","Level 3","567","105","293","77","22","1064"
201920,"East Staffordshire","LADU","Level 2","89","55","88","63","17","312"
201920,"East Staffordshire","LADU","All other qualifications","26","27","66","42","21","182"
202021,"East Staffordshire","LADU","Total","870","203","490","232","68","1863"
202021,"East Staffordshire","LADU","Level 3","746","107","326","136","26","1341"
202021,"East Staffordshire","LADU","Level 2","85","59","107","47","16","314"
202021,"East Staffordshire","LADU","All other qualifications","39","37","57","49","26","208"
201718,"Herefordshire, County of","LADU","Total","1016","180","644","239","147","2226"
201718,"Herefordshire, County of","LADU","Level 3","945","95","463","138","82","1723"
201718,"Herefordshire, County of","LADU","Level 2","56","47","124","54","34","315"
201718,"Herefordshire, County of","LADU","All other qualifications","15","38","57","47","31","188"
201819,"Herefordshire, County of","LADU","Total","892","257","764","352","139","2404"
201819,"Herefordshire, County of","LADU","Level 3","791","107","460","156","67","1581"
201819,"Herefordshire, County of","LADU","Level 2","73","106","230","113","48","570"
201819,"Herefordshire, County of","LADU","All other qualifications","28","44","74","83","24","253"
201920,"Herefordshire, County of","LADU","Total","992","215","709","297","122","2335"
201920,"Herefordshire, County of","LADU","Level 3","911","93","496","153","63","1716"
201920,"Herefordshire, County of","LADU","Level 2","59","73","114","72","35","353"
201920,"Herefordshire, County of","LADU","All other qualifications","22","49","99","72","24","266"
202021,"Herefordshire, County of","LADU","Total","1185","185","730","407","149","2656"
202021,"Herefordshire, County of","LADU","Level 3","997","84","508","166","75","1830"
202021,"Herefordshire, County of","LADU","Level 2","120","45","140","121","33","459"
202021,"Herefordshire, County of","LADU","All other qualifications","68","56","82","120","41","367"
201718,"Lichfield","LADU","Total","265","56","99","18","10","448"
201718,"Lichfield","LADU","Level 3","262","51","96","17","10","436"
201718,"Lichfield","LADU","Level 2","2","0","0","0","0","2"
201718,"Lichfield","LADU","All other qualifications","1","5","3","1","0","10"
201819,"Lichfield","LADU","Total","262","40","95","24","22","443"
201819,"Lichfield","LADU","Level 3","261","39","92","24","21","437"
201819,"Lichfield","LADU","Level 2","1","0","1","0","0","2"
201819,"Lichfield","LADU","All other qualifications","0","1","2","0","1","4"
201920,"Lichfield","LADU","Total","243","55","93","19","18","428"
201920,"Lichfield","LADU","Level 3","240","52","91","19","15","417"
201920,"Lichfield","LADU","Level 2","0","0","1","0","0","1"
201920,"Lichfield","LADU","All other qualifications","3","3","1","0","3","10"
202021,"Lichfield","LADU","Total","235","39","65","27","13","379"
202021,"Lichfield","LADU","Level 3","234","25","61","24","13","357"
202021,"Lichfield","LADU","Level 2","0","6","0","1","0","7"
202021,"Lichfield","LADU","All other qualifications","1","8","4","2","0","15"
201718,"Malvern Hills","LADU","Total","172","24","67","32","18","313"
201718,"Malvern Hills","LADU","Level 3","171","22","66","30","18","307"
201718,"Malvern Hills","LADU","Level 2","0","1","0","2","0","3"
201718,"Malvern Hills","LADU","All other qualifications","1","1","1","0","0","3"
201819,"Malvern Hills","LADU","Total","110","11","75","16","10","222"
201819,"Malvern Hills","LADU","Level 3","108","10","73","15","8","214"
201819,"Malvern Hills","LADU","Level 2","2","1","1","0","1","5"
201819,"Malvern Hills","LADU","All other qualifications","0","0","1","1","1","3"
201920,"Malvern Hills","LADU","Total","117","26","74","23","9","249"
201920,"Malvern Hills","LADU","Level 3","114","25","74","19","8","240"
201920,"Malvern Hills","LADU","Level 2","0","0","0","2","0","2"
201920,"Malvern Hills","LADU","All other qualifications","3","1","0","2","1","7"
202021,"Malvern Hills","LADU","Total","134","25","69","25","12","265"
202021,"Malvern Hills","LADU","Level 3","132","20","67","24","9","252"
202021,"Malvern Hills","LADU","Level 2","1","1","1","0","1","4"
202021,"Malvern Hills","LADU","All other qualifications","1","4","1","1","2","9"
201718,"Newcastle-under-Lyme","LADU","Total","762","226","453","200","70","1711"
201718,"Newcastle-under-Lyme","LADU","Level 3","656","115","289","100","28","1188"
201718,"Newcastle-under-Lyme","LADU","Level 2","82","83","111","48","21","345"
201718,"Newcastle-under-Lyme","LADU","All other qualifications","24","28","53","52","21","178"
201819,"Newcastle-under-Lyme","LADU","Total","1177","294","645","265","88","2469"
201819,"Newcastle-under-Lyme","LADU","Level 3","907","139","404","106","37","1593"
201819,"Newcastle-under-Lyme","LADU","Level 2","224","99","166","91","24","604"
201819,"Newcastle-under-Lyme","LADU","All other qualifications","46","56","75","68","27","272"
201920,"Newcastle-under-Lyme","LADU","Total","960","260","652","272","83","2227"
201920,"Newcastle-under-Lyme","LADU","Level 3","845","129","391","120","41","1526"
201920,"Newcastle-under-Lyme","LADU","Level 2","76","83","163","74","19","415"
201920,"Newcastle-under-Lyme","LADU","All other qualifications","39","48","98","78","23","286"
202021,"Newcastle-under-Lyme","LADU","Total","1250","209","666","374","94","2593"
202021,"Newcastle-under-Lyme","LADU","Level 3","855","93","408","164","37","1557"
202021,"Newcastle-under-Lyme","LADU","Level 2","284","70","177","105","27","663"
202021,"Newcastle-under-Lyme","LADU","All other qualifications","111","46","81","105","30","373"
201718,"North Warwickshire","LADU","Total","78","20","44","16","6","164"
201718,"North Warwickshire","LADU","Level 3","77","18","43","15","6","159"
201718,"North Warwickshire","LADU","Level 2","1","1","1","1","0","4"
201718,"North Warwickshire","LADU","All other qualifications","0","1","0","0","0","1"
201819,"North Warwickshire","LADU","Total","117","24","64","14","8","227"
201819,"North Warwickshire","LADU","Level 3","116","22","61","12","8","219"
201819,"North Warwickshire","LADU","Level 2","0","2","2","2","0","6"
201819,"North Warwickshire","LADU","All other qualifications","1","0","1","0","0","2"
201920,"North Warwickshire","LADU","Total","129","20","62","21","9","241"
201920,"North Warwickshire","LADU","Level 3","119","16","55","19","7","216"
201920,"North Warwickshire","LADU","Level 2","4","0","2","1","2","9"
201920,"North Warwickshire","LADU","All other qualifications","6","4","5","1","0","16"
202021,"North Warwickshire","LADU","Total","123","15","49","25","6","218"
202021,"North Warwickshire","LADU","Level 3","120","14","43","23","6","206"
202021,"North Warwickshire","LADU","Level 2","2","1","2","1","0","6"
202021,"North Warwickshire","LADU","All other qualifications","1","0","4","1","0","6"
201718,"Nuneaton and Bedworth","LADU","Total","723","241","531","228","90","1813"
201718,"Nuneaton and Bedworth","LADU","Level 3","673","105","264","82","36","1160"
201718,"Nuneaton and Bedworth","LADU","Level 2","32","80","155","75","23","365"
201718,"Nuneaton and Bedworth","LADU","All other qualifications","18","56","112","71","31","288"
201819,"Nuneaton and Bedworth","LADU","Total","981","282","745","342","133","2483"
201819,"Nuneaton and Bedworth","LADU","Level 3","638","108","328","107","34","1215"
201819,"Nuneaton and Bedworth","LADU","Level 2","268","106","277","113","51","815"
201819,"Nuneaton and Bedworth","LADU","All other qualifications","75","68","140","122","48","453"
201920,"Nuneaton and Bedworth","LADU","Total","937","258","627","319","100","2241"
201920,"Nuneaton and Bedworth","LADU","Level 3","801","110","343","119","40","1413"
201920,"Nuneaton and Bedworth","LADU","Level 2","96","62","153","75","22","408"
201920,"Nuneaton and Bedworth","LADU","All other qualifications","40","86","131","125","38","420"
202021,"Nuneaton and Bedworth","LADU","Total","1151","192","634","435","103","2515"
202021,"Nuneaton and Bedworth","LADU","Level 3","836","74","335","142","32","1419"
202021,"Nuneaton and Bedworth","LADU","Level 2","178","62","162","117","22","541"
202021,"Nuneaton and Bedworth","LADU","All other qualifications","137","56","137","176","49","555"
201718,"Redditch","LADU","Total","462","230","468","247","87","1494"
201718,"Redditch","LADU","Level 3","389","96","228","68","17","798"
201718,"Redditch","LADU","Level 2","38","71","101","51","17","278"
201718,"Redditch","LADU","All other qualifications","35","63","139","128","53","418"
201819,"Redditch","LADU","Total","433","312","676","357","111","1889"
201819,"Redditch","LADU","Level 3","308","78","208","55","20","669"
201819,"Redditch","LADU","Level 2","86","142","304","137","36","705"
201819,"Redditch","LADU","All other qualifications","39","92","164","165","55","515"
201920,"Redditch","LADU","Total","451","234","569","349","86","1689"
201920,"Redditch","LADU","Level 3","350","73","239","63","22","747"
201920,"Redditch","LADU","Level 2","59","99","184","104","21","467"
201920,"Redditch","LADU","All other qualifications","42","62","146","182","43","475"
202021,"Redditch","LADU","Total","686","172","521","356","99","1834"
202021,"Redditch","LADU","Level 3","456","52","190","99","22","819"
202021,"Redditch","LADU","Level 2","146","58","195","106","32","537"
202021,"Redditch","LADU","All other qualifications","84","62","136","151","45","478"
201718,"Rugby","LADU","Total","350","28","94","16","13","501"
201718,"Rugby","LADU","Level 3","348","26","92","16","11","493"
201718,"Rugby","LADU","Level 2","1","1","2","0","1","5"
201718,"Rugby","LADU","All other qualifications","1","1","0","0","1","3"
201819,"Rugby","LADU","Total","363","40","86","21","13","523"
201819,"Rugby","LADU","Level 3","359","31","78","21","11","500"
201819,"Rugby","LADU","Level 2","3","3","8","0","2","16"
201819,"Rugby","LADU","All other qualifications","1","6","0","0","0","7"
201920,"Rugby","LADU","Total","381","41","95","35","20","572"
201920,"Rugby","LADU","Level 3","379","28","82","33","19","541"
201920,"Rugby","LADU","Level 2","1","4","7","1","0","13"
201920,"Rugby","LADU","All other qualifications","1","9","6","1","1","18"
202021,"Rugby","LADU","Total","405","12","79","23","21","540"
202021,"Rugby","LADU","Level 3","399","11","77","21","20","528"
202021,"Rugby","LADU","All other qualifications","6","1","2","2","1","12"
201718,"Sandwell","LADU","Total","1490","188","464","472","211","2825"
201718,"Sandwell","LADU","Level 3","1131","98","276","204","89","1798"
201718,"Sandwell","LADU","Level 2","196","39","81","110","37","463"
201718,"Sandwell","LADU","All other qualifications","163","51","107","158","85","564"
201819,"Sandwell","LADU","Total","1743","232","501","522","211","3209"
201819,"Sandwell","LADU","Level 3","1135","118","250","191","69","1763"
201819,"Sandwell","LADU","Level 2","438","65","162","140","52","857"
201819,"Sandwell","LADU","All other qualifications","170","49","89","191","90","589"
201920,"Sandwell","LADU","Total","1692","178","431","518","200","3019"
201920,"Sandwell","LADU","Level 3","1264","98","254","217","78","1911"
201920,"Sandwell","LADU","Level 2","276","54","89","112","29","560"
201920,"Sandwell","LADU","All other qualifications","152","26","88","189","93","548"
202021,"Sandwell","LADU","Total","2125","136","427","703","184","3575"
202021,"Sandwell","LADU","Level 3","1434","62","239","307","77","2119"
202021,"Sandwell","LADU","Level 2","457","41","100","160","28","786"
202021,"Sandwell","LADU","All other qualifications","234","33","88","236","79","670"
201718,"Shropshire","LADU","Total","993","244","776","284","133","2430"
201718,"Shropshire","LADU","Level 3","917","160","619","148","82","1926"
201718,"Shropshire","LADU","Level 2","38","54","89","62","21","264"
201718,"Shropshire","LADU","All other qualifications","38","30","68","74","30","240"
201819,"Shropshire","LADU","Total","959","273","868","348","142","2590"
201819,"Shropshire","LADU","Level 3","862","138","588","149","81","1818"
201819,"Shropshire","LADU","Level 2","70","82","193","100","32","477"
201819,"Shropshire","LADU","All other qualifications","27","53","87","99","29","295"
201920,"Shropshire","LADU","Total","1109","285","780","345","141","2660"
201920,"Shropshire","LADU","Level 3","930","153","550","183","85","1901"
201920,"Shropshire","LADU","Level 2","113","59","146","81","22","421"
201920,"Shropshire","LADU","All other qualifications","66","73","84","81","34","338"
202021,"Shropshire","LADU","Total","956","149","584","322","105","2116"
202021,"Shropshire","LADU","Level 3","781","68","404","161","61","1475"
202021,"Shropshire","LADU","Level 2","120","37","86","74","17","334"
202021,"Shropshire","LADU","All other qualifications","55","44","94","87","27","307"
201718,"Solihull","LADU","Total","1820","342","874","469","215","3720"
201718,"Solihull","LADU","Level 3","1592","210","618","249","104","2773"
201718,"Solihull","LADU","Level 2","170","70","146","88","47","521"
201718,"Solihull","LADU","All other qualifications","58","62","110","132","64","426"
201819,"Solihull","LADU","Total","1677","333","885","541","189","3625"
201819,"Solihull","LADU","Level 3","1499","211","577","259","87","2633"
201819,"Solihull","LADU","Level 2","151","64","200","132","36","583"
201819,"Solihull","LADU","All other qualifications","27","58","108","150","66","409"
201920,"Solihull","LADU","Total","2119","310","1041","655","218","4343"
201920,"Solihull","LADU","Level 3","1833","201","729","309","112","3184"
201920,"Solihull","LADU","Level 2","208","51","178","161","38","636"
201920,"Solihull","LADU","All other qualifications","78","58","134","185","68","523"
202021,"Solihull","LADU","Total","2175","315","762","747","217","4216"
202021,"Solihull","LADU","Level 3","1718","156","506","347","91","2818"
202021,"Solihull","LADU","Level 2","329","78","146","182","34","769"
202021,"Solihull","LADU","All other qualifications","128","81","110","218","92","629"
201718,"South Staffordshire","LADU","Total","267","62","88","28","12","457"
201718,"South Staffordshire","LADU","Level 3","265","54","86","24","12","441"
201718,"South Staffordshire","LADU","Level 2","1","0","1","2","0","4"
201718,"South Staffordshire","LADU","All other qualifications","1","8","1","2","0","12"
201819,"South Staffordshire","LADU","Total","214","42","61","34","16","367"
201819,"South Staffordshire","LADU","Level 3","208","38","57","30","14","347"
201819,"South Staffordshire","LADU","Level 2","6","4","2","3","1","16"
201819,"South Staffordshire","LADU","All other qualifications","0","0","2","1","1","4"
201920,"South Staffordshire","LADU","Total","580","170","516","318","97","1681"
201920,"South Staffordshire","LADU","Level 3","416","80","254","123","42","915"
201920,"South Staffordshire","LADU","Level 2","87","56","147","81","25","396"
201920,"South Staffordshire","LADU","All other qualifications","77","34","115","114","30","370"
202021,"South Staffordshire","LADU","Total","584","130","384","279","83","1460"
202021,"South Staffordshire","LADU","Level 3","432","48","199","112","32","823"
202021,"South Staffordshire","LADU","Level 2","78","40","104","59","17","298"
202021,"South Staffordshire","LADU","All other qualifications","74","42","81","108","34","339"
201718,"Stafford","LADU","Total","604","150","385","150","48","1337"
201718,"Stafford","LADU","Level 3","503","61","231","65","13","873"
201718,"Stafford","LADU","Level 2","81","53","92","33","15","274"
201718,"Stafford","LADU","All other qualifications","20","36","62","52","20","190"
201819,"Stafford","LADU","Total","272","87","170","60","34","623"
201819,"Stafford","LADU","Level 3","260","35","109","12","18","434"
201819,"Stafford","LADU","Level 2","7","19","26","17","2","71"
201819,"Stafford","LADU","All other qualifications","5","33","35","31","14","118"
201920,"Stafford","LADU","Total","230","78","145","63","23","539"
201920,"Stafford","LADU","Level 3","222","33","96","17","12","380"
201920,"Stafford","LADU","Level 2","2","14","27","17","0","60"
201920,"Stafford","LADU","All other qualifications","6","31","22","29","11","99"
202021,"Stafford","LADU","Total","238","28","52","26","8","352"
202021,"Stafford","LADU","Level 3","236","19","47","18","8","328"
202021,"Stafford","LADU","Level 2","1","0","1","3","0","5"
202021,"Stafford","LADU","All other qualifications","1","9","4","5","0","19"
201718,"Staffordshire Moorlands","LADU","Total","274","58","101","28","12","473"
201718,"Staffordshire Moorlands","LADU","Level 3","272","54","98","24","9","457"
201718,"Staffordshire Moorlands","LADU","Level 2","1","3","3","2","3","12"
201718,"Staffordshire Moorlands","LADU","All other qualifications","1","1","0","2","0","4"
201819,"Staffordshire Moorlands","LADU","Total","251","31","92","23","14","411"
201819,"Staffordshire Moorlands","LADU","Level 3","243","25","83","21","14","386"
201819,"Staffordshire Moorlands","LADU","Level 2","7","3","9","2","0","21"
201819,"Staffordshire Moorlands","LADU","All other qualifications","1","3","0","0","0","4"
201920,"Staffordshire Moorlands","LADU","Total","257","48","89","36","15","445"
201920,"Staffordshire Moorlands","LADU","Level 3","245","40","81","34","13","413"
201920,"Staffordshire Moorlands","LADU","Level 2","2","5","2","0","2","11"
201920,"Staffordshire Moorlands","LADU","All other qualifications","10","3","6","2","0","21"
202021,"Staffordshire Moorlands","LADU","Total","256","22","101","40","3","422"
202021,"Staffordshire Moorlands","LADU","Level 3","249","19","88","32","3","391"
202021,"Staffordshire Moorlands","LADU","Level 2","2","1","8","5","0","16"
202021,"Staffordshire Moorlands","LADU","All other qualifications","5","2","5","3","0","15"
201718,"Stoke-on-Trent","LADU","Total","884","194","449","306","102","1935"
201718,"Stoke-on-Trent","LADU","Level 3","706","91","248","96","32","1173"
201718,"Stoke-on-Trent","LADU","Level 2","99","65","104","51","14","333"
201718,"Stoke-on-Trent","LADU","All other qualifications","79","38","97","159","56","429"
201819,"Stoke-on-Trent","LADU","Total","912","186","445","301","97","1941"
201819,"Stoke-on-Trent","LADU","Level 3","708","65","240","80","31","1124"
201819,"Stoke-on-Trent","LADU","Level 2","143","61","101","80","18","403"
201819,"Stoke-on-Trent","LADU","All other qualifications","61","60","104","141","48","414"
201920,"Stoke-on-Trent","LADU","Total","1006","152","415","329","96","1998"
201920,"Stoke-on-Trent","LADU","Level 3","828","54","220","106","32","1240"
201920,"Stoke-on-Trent","LADU","Level 2","107","49","103","86","26","371"
201920,"Stoke-on-Trent","LADU","All other qualifications","71","49","92","137","38","387"
202021,"Stoke-on-Trent","LADU","Total","986","117","399","314","87","1903"
202021,"Stoke-on-Trent","LADU","Level 3","744","29","207","101","30","1111"
202021,"Stoke-on-Trent","LADU","Level 2","141","36","95","81","17","370"
202021,"Stoke-on-Trent","LADU","All other qualifications","101","52","97","132","40","422"
201718,"Stratford-on-Avon","LADU","Total","721","99","435","125","60","1440"
201718,"Stratford-on-Avon","LADU","Level 3","669","68","360","81","31","1209"
201718,"Stratford-on-Avon","LADU","Level 2","34","18","46","19","14","131"
201718,"Stratford-on-Avon","LADU","All other qualifications","18","13","29","25","15","100"
201819,"Stratford-on-Avon","LADU","Total","728","85","397","103","52","1365"
201819,"Stratford-on-Avon","LADU","Level 3","700","63","307","59","31","1160"
201819,"Stratford-on-Avon","LADU","Level 2","24","12","62","20","6","124"
201819,"Stratford-on-Avon","LADU","All other qualifications","4","10","28","24","15","81"
201920,"Stratford-on-Avon","LADU","Total","522","62","273","78","39","974"
201920,"Stratford-on-Avon","LADU","Level 3","514","41","225","52","21","853"
201920,"Stratford-on-Avon","LADU","Level 2","0","12","28","9","4","53"
201920,"Stratford-on-Avon","LADU","All other qualifications","8","9","20","17","14","68"
202021,"Stratford-on-Avon","LADU","Total","604","43","236","91","41","1015"
202021,"Stratford-on-Avon","LADU","Level 3","597","26","199","60","32","914"
202021,"Stratford-on-Avon","LADU","Level 2","3","14","14","10","7","48"
202021,"Stratford-on-Avon","LADU","All other qualifications","4","3","23","21","2","53"
201718,"Tamworth","LADU","Total","165","34","74","21","8","302"
201718,"Tamworth","LADU","Level 3","162","32","62","19","8","283"
201718,"Tamworth","LADU","Level 2","1","0","6","1","0","8"
201718,"Tamworth","LADU","All other qualifications","2","2","6","1","0","11"
201819,"Tamworth","LADU","Total","102","25","67","18","10","222"
201819,"Tamworth","LADU","Level 3","100","21","56","15","8","200"
201819,"Tamworth","LADU","Level 2","2","1","2","1","0","6"
201819,"Tamworth","LADU","All other qualifications","0","3","9","2","2","16"
201920,"Tamworth","LADU","Total","145","24","77","30","20","296"
201920,"Tamworth","LADU","Level 3","130","18","56","17","11","232"
201920,"Tamworth","LADU","Level 2","7","3","8","5","5","28"
201920,"Tamworth","LADU","All other qualifications","8","3","13","8","4","36"
202021,"Tamworth","LADU","Total","106","23","78","35","7","249"
202021,"Tamworth","LADU","Level 3","93","14","55","22","2","186"
202021,"Tamworth","LADU","Level 2","3","2","8","6","1","20"
202021,"Tamworth","LADU","All other qualifications","10","7","15","7","4","43"
201718,"Telford and Wrekin","LADU","Total","716","220","468","216","81","1701"
201718,"Telford and Wrekin","LADU","Level 3","614","111","264","76","29","1094"
201718,"Telford and Wrekin","LADU","Level 2","44","76","144","83","29","376"
201718,"Telford and Wrekin","LADU","All other qualifications","58","33","60","57","23","231"
201819,"Telford and Wrekin","LADU","Total","744","181","474","203","72","1674"
201819,"Telford and Wrekin","LADU","Level 3","603","94","268","60","26","1051"
201819,"Telford and Wrekin","LADU","Level 2","75","57","143","81","22","378"
201819,"Telford and Wrekin","LADU","All other qualifications","66","30","63","62","24","245"
201920,"Telford and Wrekin","LADU","Total","784","152","433","226","50","1645"
201920,"Telford and Wrekin","LADU","Level 3","670","92","286","87","26","1161"
201920,"Telford and Wrekin","LADU","Level 2","64","38","90","77","11","280"
201920,"Telford and Wrekin","LADU","All other qualifications","50","22","57","62","13","204"
202021,"Telford and Wrekin","LADU","Total","873","128","338","250","58","1647"
202021,"Telford and Wrekin","LADU","Level 3","710","74","236","106","31","1157"
202021,"Telford and Wrekin","LADU","Level 2","100","29","58","67","9","263"
202021,"Telford and Wrekin","LADU","All other qualifications","63","25","44","77","18","227"
201718,"Walsall","LADU","Total","1507","338","566","414","201","3026"
201718,"Walsall","LADU","Level 3","1176","162","326","181","93","1938"
201718,"Walsall","LADU","Level 2","199","83","137","106","34","559"
201718,"Walsall","LADU","All other qualifications","132","93","103","127","74","529"
201819,"Walsall","LADU","Total","1266","345","584","426","201","2822"
201819,"Walsall","LADU","Level 3","1095","176","297","162","75","1805"
201819,"Walsall","LADU","Level 2","107","99","194","138","49","587"
201819,"Walsall","LADU","All other qualifications","64","70","93","126","77","430"
201920,"Walsall","LADU","Total","1694","321","705","589","220","3529"
201920,"Walsall","LADU","Level 3","1252","136","400","259","86","2133"
201920,"Walsall","LADU","Level 2","255","100","180","165","37","737"
201920,"Walsall","LADU","All other qualifications","187","85","125","165","97","659"
202021,"Walsall","LADU","Total","1789","259","519","575","176","3318"
202021,"Walsall","LADU","Level 3","1271","99","264","236","80","1950"
202021,"Walsall","LADU","Level 2","371","90","151","159","35","806"
202021,"Walsall","LADU","All other qualifications","147","70","104","180","61","562"
201718,"Warwick","LADU","Total","1084","304","763","320","143","2614"
201718,"Warwick","LADU","Level 3","796","141","433","128","74","1572"
201718,"Warwick","LADU","Level 2","210","97","182","66","30","585"
201718,"Warwick","LADU","All other qualifications","78","66","148","126","39","457"
201819,"Warwick","LADU","Total","1044","288","848","401","144","2725"
201819,"Warwick","LADU","Level 3","689","105","422","106","51","1373"
201819,"Warwick","LADU","Level 2","252","94","255","131","51","783"
201819,"Warwick","LADU","All other qualifications","103","89","171","164","42","569"
201920,"Warwick","LADU","Total","1005","262","782","406","132","2587"
201920,"Warwick","LADU","Level 3","726","83","369","100","39","1317"
201920,"Warwick","LADU","Level 2","174","97","212","92","37","612"
201920,"Warwick","LADU","All other qualifications","105","82","201","214","56","658"
202021,"Warwick","LADU","Total","1094","257","653","509","118","2631"
202021,"Warwick","LADU","Level 3","770","85","316","133","25","1329"
202021,"Warwick","LADU","Level 2","192","80","156","112","29","569"
202021,"Warwick","LADU","All other qualifications","132","92","181","264","64","733"
201718,"Wolverhampton","LADU","Total","1157","237","398","300","142","2234"
201718,"Wolverhampton","LADU","Level 3","1055","127","243","131","74","1630"
201718,"Wolverhampton","LADU","Level 2","60","57","88","63","29","297"
201718,"Wolverhampton","LADU","All other qualifications","42","53","67","106","39","307"
201819,"Wolverhampton","LADU","Total","1107","232","357","343","129","2168"
201819,"Wolverhampton","LADU","Level 3","990","121","197","119","56","1483"
201819,"Wolverhampton","LADU","Level 2","89","76","109","101","33","408"
201819,"Wolverhampton","LADU","All other qualifications","28","35","51","123","40","277"
201920,"Wolverhampton","LADU","Total","1228","175","370","354","139","2266"
201920,"Wolverhampton","LADU","Level 3","1077","84","217","153","70","1601"
201920,"Wolverhampton","LADU","Level 2","91","55","75","83","18","322"
201920,"Wolverhampton","LADU","All other qualifications","60","36","78","118","51","343"
202021,"Wolverhampton","LADU","Total","1363","154","388","423","116","2444"
202021,"Wolverhampton","LADU","Level 3","1112","69","246","222","70","1719"
202021,"Wolverhampton","LADU","Level 2","175","50","84","96","18","423"
202021,"Wolverhampton","LADU","All other qualifications","76","35","58","105","28","302"
201718,"Worcester","LADU","Total","410","88","250","76","26","850"
201718,"Worcester","LADU","Level 3","407","73","220","61","20","781"
201718,"Worcester","LADU","Level 2","2","6","14","8","3","33"
201718,"Worcester","LADU","All other qualifications","1","9","16","7","3","36"
201819,"Worcester","LADU","Total","378","84","254","53","30","799"
201819,"Worcester","LADU","Level 3","357","64","220","41","27","709"
201819,"Worcester","LADU","Level 2","19","11","20","7","2","59"
201819,"Worcester","LADU","All other qualifications","2","9","14","5","1","31"
201920,"Worcester","LADU","Total","378","82","232","75","49","816"
201920,"Worcester","LADU","Level 3","372","58","207","59","37","733"
201920,"Worcester","LADU","Level 2","5","13","14","8","7","47"
201920,"Worcester","LADU","All other qualifications","1","11","11","8","5","36"
202021,"Worcester","LADU","Total","532","43","229","82","30","916"
202021,"Worcester","LADU","Level 3","516","28","197","62","23","826"
202021,"Worcester","LADU","Level 2","11","6","12","8","3","40"
202021,"Worcester","LADU","All other qualifications","5","9","20","12","4","50"
201718,"Wychavon","LADU","Total","230","69","140","63","24","526"
201718,"Wychavon","LADU","Level 3","229","40","97","27","14","407"
201718,"Wychavon","LADU","Level 2","1","15","16","9","2","43"
201718,"Wychavon","LADU","All other qualifications","0","14","27","27","8","76"
201819,"Wychavon","LADU","Total","260","53","112","38","22","485"
201819,"Wychavon","LADU","Level 3","259","40","92","22","10","423"
201819,"Wychavon","LADU","Level 2","1","5","9","10","1","26"
201819,"Wychavon","LADU","All other qualifications","0","8","11","6","11","36"
201920,"Wychavon","LADU","Total","186","31","113","30","16","376"
201920,"Wychavon","LADU","Level 3","186","29","108","27","14","364"
201920,"Wychavon","LADU","Level 2","0","0","1","0","1","2"
201920,"Wychavon","LADU","All other qualifications","0","2","4","3","1","10"
202021,"Wychavon","LADU","Total","208","17","91","29","13","358"
202021,"Wychavon","LADU","Level 3","206","15","88","26","12","347"
202021,"Wychavon","LADU","All other qualifications","2","2","3","3","1","11"
201718,"Wyre Forest","LADU","Total","171","53","81","30","13","348"
201718,"Wyre Forest","LADU","Level 3","171","48","73","23","11","326"
201718,"Wyre Forest","LADU","Level 2","0","1","7","6","1","15"
201718,"Wyre Forest","LADU","All other qualifications","0","4","1","1","1","7"
201819,"Wyre Forest","LADU","Total","148","46","61","27","18","300"
201819,"Wyre Forest","LADU","Level 3","148","37","57","23","14","279"
201819,"Wyre Forest","LADU","Level 2","0","5","1","3","3","12"
201819,"Wyre Forest","LADU","All other qualifications","0","4","3","1","1","9"
201920,"Wyre Forest","LADU","Total","110","29","51","16","12","218"
201920,"Wyre Forest","LADU","Level 3","107","22","47","13","12","201"
201920,"Wyre Forest","LADU","Level 2","2","4","1","2","0","9"
201920,"Wyre Forest","LADU","All other qualifications","1","3","3","1","0","8"
202021,"Wyre Forest","LADU","Total","123","15","48","29","8","223"
202021,"Wyre Forest","LADU","Level 3","119","6","40","24","8","197"
202021,"Wyre Forest","LADU","Level 2","0","3","4","1","0","8"
202021,"Wyre Forest","LADU","All other qualifications","4","6","4","4","0","18"
201718,"Babergh","LADU","Total","466","90","285","66","25","932"
201718,"Babergh","LADU","Level 3","446","79","262","56","22","865"
201718,"Babergh","LADU","Level 2","3","4","13","6","1","27"
201718,"Babergh","LADU","All other qualifications","17","7","10","4","2","40"
201819,"Babergh","LADU","Total","505","105","269","92","30","1001"
201819,"Babergh","LADU","Level 3","423","88","216","74","21","822"
201819,"Babergh","LADU","Level 2","57","12","36","12","3","120"
201819,"Babergh","LADU","All other qualifications","25","5","17","6","6","59"
201920,"Babergh","LADU","Total","458","124","284","84","32","982"
201920,"Babergh","LADU","Level 3","447","106","262","68","29","912"
201920,"Babergh","LADU","Level 2","5","8","15","11","2","41"
201920,"Babergh","LADU","All other qualifications","6","10","7","5","1","29"
202021,"Babergh","LADU","Total","609","92","351","114","34","1200"
202021,"Babergh","LADU","Level 3","520","74","319","87","28","1028"
202021,"Babergh","LADU","Level 2","44","11","13","8","2","78"
202021,"Babergh","LADU","All other qualifications","45","7","19","19","4","94"
201718,"Basildon","LADU","Total","296","224","244","130","61","955"
201718,"Basildon","LADU","Level 3","280","95","148","42","11","576"
201718,"Basildon","LADU","Level 2","10","60","49","43","13","175"
201718,"Basildon","LADU","All other qualifications","6","69","47","45","37","204"
201819,"Basildon","LADU","Total","251","184","224","104","66","829"
201819,"Basildon","LADU","Level 3","231","90","140","40","18","519"
201819,"Basildon","LADU","Level 2","9","60","40","30","22","161"
201819,"Basildon","LADU","All other qualifications","11","34","44","34","26","149"
201920,"Basildon","LADU","Total","253","161","222","98","45","779"
201920,"Basildon","LADU","Level 3","244","71","136","49","14","514"
201920,"Basildon","LADU","Level 2","5","45","53","19","14","136"
201920,"Basildon","LADU","All other qualifications","4","45","33","30","17","129"
202021,"Basildon","LADU","Total","279","146","167","100","46","738"
202021,"Basildon","LADU","Level 3","257","58","110","61","22","508"
202021,"Basildon","LADU","Level 2","17","53","34","17","9","130"
202021,"Basildon","LADU","All other qualifications","5","35","23","22","15","100"
201718,"Bedford","LADU","Total","1226","310","833","295","162","2826"
201718,"Bedford","LADU","Level 3","953","173","564","141","80","1911"
201718,"Bedford","LADU","Level 2","196","78","159","59","32","524"
201718,"Bedford","LADU","All other qualifications","77","59","110","95","50","391"
201819,"Bedford","LADU","Total","1439","320","982","416","167","3324"
201819,"Bedford","LADU","Level 3","1012","143","552","165","88","1960"
201819,"Bedford","LADU","Level 2","283","96","236","128","32","775"
201819,"Bedford","LADU","All other qualifications","144","81","194","123","47","589"
201920,"Bedford","LADU","Total","1416","263","1016","485","151","3331"
201920,"Bedford","LADU","Level 3","1113","122","613","187","59","2094"
201920,"Bedford","LADU","Level 2","184","79","248","135","37","683"
201920,"Bedford","LADU","All other qualifications","119","62","155","163","55","554"
202021,"Bedford","LADU","Total","1602","275","1100","617","203","3797"
202021,"Bedford","LADU","Level 3","1163","97","617","254","89","2220"
202021,"Bedford","LADU","Level 2","310","86","278","153","39","866"
202021,"Bedford","LADU","All other qualifications","129","92","205","210","75","711"
201718,"Braintree","LADU","Total","154","44","88","30","16","332"
201718,"Braintree","LADU","Level 3","153","33","76","20","13","295"
201718,"Braintree","LADU","Level 2","0","9","11","6","3","29"
201718,"Braintree","LADU","All other qualifications","1","2","1","4","0","8"
201819,"Braintree","LADU","Total","131","32","118","31","14","326"
201819,"Braintree","LADU","Level 3","127","26","104","23","10","290"
201819,"Braintree","LADU","Level 2","4","4","4","7","4","23"
201819,"Braintree","LADU","All other qualifications","0","2","10","1","0","13"
201920,"Braintree","LADU","Total","163","33","108","33","16","353"
201920,"Braintree","LADU","Level 3","159","29","98","22","10","318"
201920,"Braintree","LADU","Level 2","2","1","4","9","2","18"
201920,"Braintree","LADU","All other qualifications","2","3","6","2","4","17"
202021,"Braintree","LADU","Total","151","28","99","36","19","333"
202021,"Braintree","LADU","Level 3","144","18","80","25","10","277"
202021,"Braintree","LADU","Level 2","5","4","12","8","6","35"
202021,"Braintree","LADU","All other qualifications","2","6","7","3","3","21"
201718,"Breckland","LADU","Total","180","35","133","36","21","405"
201718,"Breckland","LADU","Level 3","178","29","120","32","18","377"
201718,"Breckland","LADU","Level 2","2","2","7","3","1","15"
201718,"Breckland","LADU","All other qualifications","0","4","6","1","2","13"
201819,"Breckland","LADU","Total","144","19","102","36","16","317"
201819,"Breckland","LADU","Level 3","142","16","93","25","15","291"
201819,"Breckland","LADU","Level 2","1","2","5","7","0","15"
201819,"Breckland","LADU","All other qualifications","1","1","4","4","1","11"
201920,"Breckland","LADU","Total","143","18","91","27","18","297"
201920,"Breckland","LADU","Level 3","139","12","83","21","13","268"
201920,"Breckland","LADU","Level 2","1","2","2","2","3","10"
201920,"Breckland","LADU","All other qualifications","3","4","6","4","2","19"
202021,"Breckland","LADU","Total","173","20","69","37","14","313"
202021,"Breckland","LADU","Level 3","164","15","61","26","12","278"
202021,"Breckland","LADU","Level 2","4","1","3","7","0","15"
202021,"Breckland","LADU","All other qualifications","5","4","5","4","2","20"
201718,"Brentwood","LADU","Total","401","68","174","45","27","715"
201718,"Brentwood","LADU","Level 3","398","61","170","43","26","698"
201718,"Brentwood","LADU","Level 2","3","2","2","1","0","8"
201718,"Brentwood","LADU","All other qualifications","0","5","2","1","1","9"
201819,"Brentwood","LADU","Total","431","65","186","48","34","764"
201819,"Brentwood","LADU","Level 3","421","59","179","47","32","738"
201819,"Brentwood","LADU","Level 2","6","3","5","0","0","14"
201819,"Brentwood","LADU","All other qualifications","4","3","2","1","2","12"
201920,"Brentwood","LADU","Total","410","77","186","49","40","762"
201920,"Brentwood","LADU","Level 3","405","72","176","42","38","733"
201920,"Brentwood","LADU","Level 2","1","1","1","3","0","6"
201920,"Brentwood","LADU","All other qualifications","4","4","9","4","2","23"
202021,"Brentwood","LADU","Total","487","49","142","73","38","789"
202021,"Brentwood","LADU","Level 3","483","35","136","68","36","758"
202021,"Brentwood","LADU","Level 2","1","2","1","0","0","4"
202021,"Brentwood","LADU","All other qualifications","3","12","5","5","2","27"
201718,"Broadland","LADU","Total","274","42","151","41","23","531"
201718,"Broadland","LADU","Level 3","274","40","145","40","20","519"
201718,"Broadland","LADU","Level 2","0","1","3","0","1","5"
201718,"Broadland","LADU","All other qualifications","0","1","3","1","2","7"
201819,"Broadland","LADU","Total","278","43","134","46","16","517"
201819,"Broadland","LADU","Level 3","275","40","131","45","15","506"
201819,"Broadland","LADU","Level 2","3","0","1","1","0","5"
201819,"Broadland","LADU","All other qualifications","0","3","2","0","1","6"
201920,"Broadland","LADU","Total","270","58","173","43","21","565"
201920,"Broadland","LADU","Level 3","264","53","167","39","17","540"
201920,"Broadland","LADU","Level 2","0","2","1","2","0","5"
201920,"Broadland","LADU","All other qualifications","6","3","5","2","4","20"
202021,"Broadland","LADU","Total","303","34","167","60","36","600"
202021,"Broadland","LADU","Level 3","286","28","151","53","32","550"
202021,"Broadland","LADU","Level 2","3","3","2","1","0","9"
202021,"Broadland","LADU","All other qualifications","14","3","14","6","4","41"
201718,"Broxbourne","LADU","Total","299","59","131","40","21","550"
201718,"Broxbourne","LADU","Level 3","298","57","130","36","18","539"
201718,"Broxbourne","LADU","Level 2","1","1","1","1","0","4"
201718,"Broxbourne","LADU","All other qualifications","0","1","0","3","3","7"
201819,"Broxbourne","LADU","Total","258","50","165","40","14","527"
201819,"Broxbourne","LADU","Level 3","258","49","161","38","12","518"
201819,"Broxbourne","LADU","Level 2","0","0","3","1","2","6"
201819,"Broxbourne","LADU","All other qualifications","0","1","1","1","0","3"
201920,"Broxbourne","LADU","Total","311","53","135","43","13","555"
201920,"Broxbourne","LADU","Level 3","303","48","127","35","12","525"
201920,"Broxbourne","LADU","Level 2","6","2","3","2","0","13"
201920,"Broxbourne","LADU","All other qualifications","2","3","5","6","1","17"
202021,"Broxbourne","LADU","Total","330","45","112","52","20","559"
202021,"Broxbourne","LADU","Level 3","323","42","105","46","17","533"
202021,"Broxbourne","LADU","Level 2","7","3","2","3","2","17"
202021,"Broxbourne","LADU","All other qualifications","0","0","5","3","1","9"
201718,"Cambridge","LADU","Total","1153","97","746","193","85","2274"
201718,"Cambridge","LADU","Level 3","1147","80","705","164","78","2174"
201718,"Cambridge","LADU","Level 2","4","10","19","19","1","53"
201718,"Cambridge","LADU","All other qualifications","2","7","22","10","6","47"
201819,"Cambridge","LADU","Total","1215","122","851","202","97","2487"
201819,"Cambridge","LADU","Level 3","1175","99","777","177","80","2308"
201819,"Cambridge","LADU","Level 2","32","10","48","16","12","118"
201819,"Cambridge","LADU","All other qualifications","8","13","26","9","5","61"
201920,"Cambridge","LADU","Total","1226","106","792","227","119","2470"
201920,"Cambridge","LADU","Level 3","1218","89","735","203","107","2352"
201920,"Cambridge","LADU","Level 2","3","5","24","10","1","43"
201920,"Cambridge","LADU","All other qualifications","5","12","33","14","11","75"
202021,"Cambridge","LADU","Total","1464","93","663","271","147","2638"
202021,"Cambridge","LADU","Level 3","1368","71","609","232","129","2409"
202021,"Cambridge","LADU","Level 2","67","5","20","17","8","117"
202021,"Cambridge","LADU","All other qualifications","29","17","34","22","10","112"
201718,"Castle Point","LADU","Total","635","167","442","159","61","1464"
201718,"Castle Point","LADU","Level 3","566","119","340","96","35","1156"
201718,"Castle Point","LADU","Level 2","40","31","63","31","13","178"
201718,"Castle Point","LADU","All other qualifications","29","17","39","32","13","130"
201819,"Castle Point","LADU","Total","877","229","657","214","61","2038"
201819,"Castle Point","LADU","Level 3","753","164","486","135","29","1567"
201819,"Castle Point","LADU","Level 2","100","34","101","37","16","288"
201819,"Castle Point","LADU","All other qualifications","24","31","70","42","16","183"
201920,"Castle Point","LADU","Total","901","179","636","239","81","2036"
201920,"Castle Point","LADU","Level 3","807","127","497","144","49","1624"
201920,"Castle Point","LADU","Level 2","55","30","65","52","8","210"
201920,"Castle Point","LADU","All other qualifications","39","22","74","43","24","202"
202021,"Castle Point","LADU","Total","856","124","511","256","61","1808"
202021,"Castle Point","LADU","Level 3","730","78","409","161","30","1408"
202021,"Castle Point","LADU","Level 2","80","18","61","48","10","217"
202021,"Castle Point","LADU","All other qualifications","46","28","41","47","21","183"
201718,"Central Bedfordshire","LADU","Total","868","208","540","184","73","1873"
201718,"Central Bedfordshire","LADU","Level 3","800","154","418","106","32","1510"
201718,"Central Bedfordshire","LADU","Level 2","35","23","70","38","12","178"
201718,"Central Bedfordshire","LADU","All other qualifications","33","31","52","40","29","185"
201819,"Central Bedfordshire","LADU","Total","827","184","547","212","85","1855"
201819,"Central Bedfordshire","LADU","Level 3","745","135","361","100","38","1379"
201819,"Central Bedfordshire","LADU","Level 2","62","23","116","57","19","277"
201819,"Central Bedfordshire","LADU","All other qualifications","20","26","70","55","28","199"
201920,"Central Bedfordshire","LADU","Total","871","141","566","238","89","1905"
201920,"Central Bedfordshire","LADU","Level 3","795","111","413","130","42","1491"
201920,"Central Bedfordshire","LADU","Level 2","46","12","86","45","18","207"
201920,"Central Bedfordshire","LADU","All other qualifications","30","18","67","63","29","207"
202021,"Central Bedfordshire","LADU","Total","908","140","542","252","94","1936"
202021,"Central Bedfordshire","LADU","Level 3","749","84","398","142","44","1417"
202021,"Central Bedfordshire","LADU","Level 2","111","25","83","51","19","289"
202021,"Central Bedfordshire","LADU","All other qualifications","48","31","61","59","31","230"
201718,"Chelmsford","LADU","Total","986","250","612","215","110","2173"
201718,"Chelmsford","LADU","Level 3","892","138","433","92","57","1612"
201718,"Chelmsford","LADU","Level 2","65","65","102","45","18","295"
201718,"Chelmsford","LADU","All other qualifications","29","47","77","78","35","266"
201819,"Chelmsford","LADU","Total","862","216","611","231","91","2011"
201819,"Chelmsford","LADU","Level 3","807","117","384","90","37","1435"
201819,"Chelmsford","LADU","Level 2","29","48","119","60","9","265"
201819,"Chelmsford","LADU","All other qualifications","26","51","108","81","45","311"
201920,"Chelmsford","LADU","Total","1059","203","649","272","110","2293"
201920,"Chelmsford","LADU","Level 3","953","108","464","132","51","1708"
201920,"Chelmsford","LADU","Level 2","60","44","86","48","18","256"
201920,"Chelmsford","LADU","All other qualifications","46","51","99","92","41","329"
202021,"Chelmsford","LADU","Total","976","183","496","245","86","1986"
202021,"Chelmsford","LADU","Level 3","871","86","342","107","45","1451"
202021,"Chelmsford","LADU","Level 2","65","41","65","48","12","231"
202021,"Chelmsford","LADU","All other qualifications","40","56","89","90","29","304"
201718,"Colchester","LADU","Total","1679","344","1101","465","220","3809"
201718,"Colchester","LADU","Level 3","1335","167","680","178","92","2452"
201718,"Colchester","LADU","Level 2","241","86","256","113","58","754"
201718,"Colchester","LADU","All other qualifications","103","91","165","174","70","603"
201819,"Colchester","LADU","Total","1548","346","1143","551","186","3774"
201819,"Colchester","LADU","Level 3","1294","159","647","211","83","2394"
201819,"Colchester","LADU","Level 2","162","105","337","171","47","822"
201819,"Colchester","LADU","All other qualifications","92","82","159","169","56","558"
201920,"Colchester","LADU","Total","1744","321","1151","552","163","3931"
201920,"Colchester","LADU","Level 3","1463","142","677","232","80","2594"
201920,"Colchester","LADU","Level 2","191","88","283","146","35","743"
201920,"Colchester","LADU","All other qualifications","90","91","191","174","48","594"
202021,"Colchester","LADU","Total","1842","244","981","566","183","3816"
202021,"Colchester","LADU","Level 3","1524","100","592","208","86","2510"
202021,"Colchester","LADU","Level 2","216","83","224","196","45","764"
202021,"Colchester","LADU","All other qualifications","102","61","165","162","52","542"
201718,"Dacorum","LADU","Total","460","35","171","38","24","728"
201718,"Dacorum","LADU","Level 3","460","31","164","34","23","712"
201718,"Dacorum","LADU","Level 2","0","2","6","3","1","12"
201718,"Dacorum","LADU","All other qualifications","0","2","1","1","0","4"
201819,"Dacorum","LADU","Total","389","34","162","50","28","663"
201819,"Dacorum","LADU","Level 3","385","31","150","43","26","635"
201819,"Dacorum","LADU","Level 2","4","1","9","6","2","22"
201819,"Dacorum","LADU","All other qualifications","0","2","3","1","0","6"
201920,"Dacorum","LADU","Total","412","27","163","51","24","677"
201920,"Dacorum","LADU","Level 3","408","26","159","49","21","663"
201920,"Dacorum","LADU","Level 2","3","1","1","2","2","9"
201920,"Dacorum","LADU","All other qualifications","1","0","3","0","1","5"
202021,"Dacorum","LADU","Total","491","22","173","55","25","766"
202021,"Dacorum","LADU","Level 3","487","16","162","50","20","735"
202021,"Dacorum","LADU","Level 2","2","3","3","3","1","12"
202021,"Dacorum","LADU","All other qualifications","2","3","8","2","4","19"
201718,"East Cambridgeshire","LADU","Total","11","4","30","10","6","61"
201718,"East Cambridgeshire","LADU","Level 3","10","3","19","4","1","37"
201718,"East Cambridgeshire","LADU","Level 2","0","1","10","3","3","17"
201718,"East Cambridgeshire","LADU","All other qualifications","1","0","1","3","2","7"
201819,"East Cambridgeshire","LADU","Total","11","7","15","10","5","48"
201819,"East Cambridgeshire","LADU","Level 3","8","4","3","1","1","17"
201819,"East Cambridgeshire","LADU","Level 2","3","2","9","8","2","24"
201819,"East Cambridgeshire","LADU","All other qualifications","0","1","3","1","2","7"
201920,"East Cambridgeshire","LADU","Total","13","6","29","5","2","55"
201920,"East Cambridgeshire","LADU","Level 3","9","3","18","2","1","33"
201920,"East Cambridgeshire","LADU","Level 2","2","3","11","2","0","18"
201920,"East Cambridgeshire","LADU","All other qualifications","2","0","0","1","1","4"
202021,"East Cambridgeshire","LADU","Total","12","2","20","9","5","48"
202021,"East Cambridgeshire","LADU","Level 3","8","2","13","3","1","27"
202021,"East Cambridgeshire","LADU","Level 2","4","0","7","5","4","20"
202021,"East Cambridgeshire","LADU","All other qualifications","0","0","0","1","0","1"
201718,"East Hertfordshire","LADU","Total","1148","219","650","257","157","2431"
201718,"East Hertfordshire","LADU","Level 3","1059","120","451","126","84","1840"
201718,"East Hertfordshire","LADU","Level 2","36","48","106","44","24","258"
201718,"East Hertfordshire","LADU","All other qualifications","53","51","93","87","49","333"
201819,"East Hertfordshire","LADU","Total","1142","186","691","293","170","2482"
201819,"East Hertfordshire","LADU","Level 3","1054","104","462","128","85","1833"
201819,"East Hertfordshire","LADU","Level 2","77","56","160","80","40","413"
201819,"East Hertfordshire","LADU","All other qualifications","11","26","69","85","45","236"
201920,"East Hertfordshire","LADU","Total","1090","200","700","310","149","2449"
201920,"East Hertfordshire","LADU","Level 3","1025","114","522","160","81","1902"
201920,"East Hertfordshire","LADU","Level 2","30","42","108","68","26","274"
201920,"East Hertfordshire","LADU","All other qualifications","35","44","70","82","42","273"
202021,"East Hertfordshire","LADU","Total","1395","131","542","350","132","2550"
202021,"East Hertfordshire","LADU","Level 3","1199","64","376","165","81","1885"
202021,"East Hertfordshire","LADU","Level 2","117","36","99","97","16","365"
202021,"East Hertfordshire","LADU","All other qualifications","79","31","67","88","35","300"
201920,"East Suffolk","LADU","Total","820","187","523","306","92","1928"
201920,"East Suffolk","LADU","Level 3","618","111","344","146","42","1261"
201920,"East Suffolk","LADU","Level 2","119","53","106","85","24","387"
201920,"East Suffolk","LADU","All other qualifications","83","23","73","75","26","280"
202021,"East Suffolk","LADU","Total","910","151","472","336","98","1967"
202021,"East Suffolk","LADU","Level 3","654","66","312","138","35","1205"
202021,"East Suffolk","LADU","Level 2","166","59","94","96","30","445"
202021,"East Suffolk","LADU","All other qualifications","90","26","66","102","33","317"
201718,"Epping Forest","LADU","Total","513","94","257","137","83","1084"
201718,"Epping Forest","LADU","Level 3","395","44","155","50","31","675"
201718,"Epping Forest","LADU","Level 2","89","20","63","35","21","228"
201718,"Epping Forest","LADU","All other qualifications","29","30","39","52","31","181"
201819,"Epping Forest","LADU","Total","463","105","270","188","68","1094"
201819,"Epping Forest","LADU","Level 3","341","52","151","72","20","636"
201819,"Epping Forest","LADU","Level 2","98","34","86","54","20","292"
201819,"Epping Forest","LADU","All other qualifications","24","19","33","62","28","166"
201920,"Epping Forest","LADU","Total","276","78","147","103","55","659"
201920,"Epping Forest","LADU","Level 3","271","37","99","32","24","463"
201920,"Epping Forest","LADU","Level 2","2","11","19","24","8","64"
201920,"Epping Forest","LADU","All other qualifications","3","30","29","47","23","132"
202021,"Epping Forest","LADU","Total","337","47","109","84","43","620"
202021,"Epping Forest","LADU","Level 3","330","22","76","41","15","484"
202021,"Epping Forest","LADU","Level 2","1","6","18","11","7","43"
202021,"Epping Forest","LADU","All other qualifications","6","19","15","32","21","93"
201718,"Fenland","LADU","Total","141","22","69","18","8","258"
201718,"Fenland","LADU","Level 3","140","21","60","15","6","242"
201718,"Fenland","LADU","Level 2","1","0","4","2","1","8"
201718,"Fenland","LADU","All other qualifications","0","1","5","1","1","8"
201819,"Fenland","LADU","Total","141","25","60","18","17","261"
201819,"Fenland","LADU","Level 3","140","24","57","17","14","252"
201819,"Fenland","LADU","Level 2","1","0","2","1","0","4"
201819,"Fenland","LADU","All other qualifications","0","1","1","0","3","5"
201920,"Fenland","LADU","Total","141","24","62","16","6","249"
201920,"Fenland","LADU","Level 3","136","18","60","14","6","234"
201920,"Fenland","LADU","Level 2","2","1","1","1","0","5"
201920,"Fenland","LADU","All other qualifications","3","5","1","1","0","10"
202021,"Fenland","LADU","Total","131","18","70","27","6","252"
202021,"Fenland","LADU","Level 3","130","12","60","26","4","232"
202021,"Fenland","LADU","Level 2","0","1","3","0","1","5"
202021,"Fenland","LADU","All other qualifications","1","5","7","1","1","15"
201718,"Forest Heath","LADU","Total","46","9","53","11","4","123"
201718,"Forest Heath","LADU","Level 3","43","7","47","11","4","112"
201718,"Forest Heath","LADU","Level 2","3","2","3","0","0","8"
201718,"Forest Heath","LADU","All other qualifications","0","0","3","0","0","3"
201819,"Forest Heath","LADU","Total","29","6","28","12","8","83"
201819,"Forest Heath","LADU","Level 3","29","6","24","11","6","76"
201819,"Forest Heath","LADU","Level 2","0","0","2","0","1","3"
201819,"Forest Heath","LADU","All other qualifications","0","0","2","1","1","4"
201718,"Great Yarmouth","LADU","Total","418","131","317","193","82","1141"
201718,"Great Yarmouth","LADU","Level 3","285","78","196","72","29","660"
201718,"Great Yarmouth","LADU","Level 2","65","32","66","44","23","230"
201718,"Great Yarmouth","LADU","All other qualifications","68","21","55","77","30","251"
201819,"Great Yarmouth","LADU","Total","335","95","195","133","39","797"
201819,"Great Yarmouth","LADU","Level 3","322","61","146","67","15","611"
201819,"Great Yarmouth","LADU","Level 2","11","18","33","23","8","93"
201819,"Great Yarmouth","LADU","All other qualifications","2","16","16","43","16","93"
201920,"Great Yarmouth","LADU","Total","307","87","216","132","52","794"
201920,"Great Yarmouth","LADU","Level 3","301","52","153","77","22","605"
201920,"Great Yarmouth","LADU","Level 2","5","19","42","31","13","110"
201920,"Great Yarmouth","LADU","All other qualifications","1","16","21","24","17","79"
202021,"Great Yarmouth","LADU","Total","528","48","155","102","27","860"
202021,"Great Yarmouth","LADU","Level 3","502","43","135","85","23","788"
202021,"Great Yarmouth","LADU","Level 2","26","4","18","14","2","64"
202021,"Great Yarmouth","LADU","All other qualifications","0","1","2","3","2","8"
201718,"Harlow","LADU","Total","293","101","418","197","91","1100"
201718,"Harlow","LADU","Level 3","244","37","210","54","29","574"
201718,"Harlow","LADU","Level 2","23","38","115","54","23","253"
201718,"Harlow","LADU","All other qualifications","26","26","93","89","39","273"
201819,"Harlow","LADU","Total","329","116","502","252","107","1306"
201819,"Harlow","LADU","Level 3","252","38","217","62","29","598"
201819,"Harlow","LADU","Level 2","46","45","182","85","38","396"
201819,"Harlow","LADU","All other qualifications","31","33","103","105","40","312"
201920,"Harlow","LADU","Total","301","113","440","254","89","1197"
201920,"Harlow","LADU","Level 3","237","32","241","70","27","607"
201920,"Harlow","LADU","Level 2","28","39","109","56","20","252"
201920,"Harlow","LADU","All other qualifications","36","42","90","128","42","338"
202021,"Harlow","LADU","Total","655","109","527","353","102","1746"
202021,"Harlow","LADU","Level 3","460","32","294","130","37","953"
202021,"Harlow","LADU","Level 2","114","45","148","95","30","432"
202021,"Harlow","LADU","All other qualifications","81","32","85","128","35","361"
201718,"Hertsmere","LADU","Total","570","41","197","69","41","918"
201718,"Hertsmere","LADU","Level 3","566","37","190","59","37","889"
201718,"Hertsmere","LADU","Level 2","1","2","3","5","3","14"
201718,"Hertsmere","LADU","All other qualifications","3","2","4","5","1","15"
201819,"Hertsmere","LADU","Total","589","34","179","60","22","884"
201819,"Hertsmere","LADU","Level 3","568","27","167","54","20","836"
201819,"Hertsmere","LADU","Level 2","17","3","8","3","0","31"
201819,"Hertsmere","LADU","All other qualifications","4","4","4","3","2","17"
201920,"Hertsmere","LADU","Total","616","26","136","80","25","883"
201920,"Hertsmere","LADU","Level 3","607","24","120","66","18","835"
201920,"Hertsmere","LADU","Level 2","3","0","8","6","4","21"
201920,"Hertsmere","LADU","All other qualifications","6","2","8","8","3","27"
202021,"Hertsmere","LADU","Total","606","34","132","79","39","890"
202021,"Hertsmere","LADU","Level 3","599","25","118","71","36","849"
202021,"Hertsmere","LADU","Level 2","2","4","3","6","1","16"
202021,"Hertsmere","LADU","All other qualifications","5","5","11","2","2","25"
201718,"Huntingdonshire","LADU","Total","482","93","361","145","51","1132"
201718,"Huntingdonshire","LADU","Level 3","425","50","233","66","23","797"
201718,"Huntingdonshire","LADU","Level 2","47","26","74","23","11","181"
201718,"Huntingdonshire","LADU","All other qualifications","10","17","54","56","17","154"
201819,"Huntingdonshire","LADU","Total","412","82","272","101","48","915"
201819,"Huntingdonshire","LADU","Level 3","405","55","203","46","30","739"
201819,"Huntingdonshire","LADU","Level 2","4","19","44","22","9","98"
201819,"Huntingdonshire","LADU","All other qualifications","3","8","25","33","9","78"
201920,"Huntingdonshire","LADU","Total","374","53","263","78","45","813"
201920,"Huntingdonshire","LADU","Level 3","358","43","205","40","34","680"
201920,"Huntingdonshire","LADU","Level 2","7","6","20","12","7","52"
201920,"Huntingdonshire","LADU","All other qualifications","9","4","38","26","4","81"
202021,"Huntingdonshire","LADU","Total","423","33","208","49","30","743"
202021,"Huntingdonshire","LADU","Level 3","406","26","176","41","24","673"
202021,"Huntingdonshire","LADU","Level 2","6","2","9","2","4","23"
202021,"Huntingdonshire","LADU","All other qualifications","11","5","23","6","2","47"
201718,"Ipswich","LADU","Total","590","178","428","186","82","1464"
201718,"Ipswich","LADU","Level 3","431","72","236","61","37","837"
201718,"Ipswich","LADU","Level 2","101","63","112","48","17","341"
201718,"Ipswich","LADU","All other qualifications","58","43","80","77","28","286"
201819,"Ipswich","LADU","Total","576","190","421","211","79","1477"
201819,"Ipswich","LADU","Level 3","334","67","205","54","29","689"
201819,"Ipswich","LADU","Level 2","173","80","136","50","29","468"
201819,"Ipswich","LADU","All other qualifications","69","43","80","107","21","320"
201920,"Ipswich","LADU","Total","588","179","396","242","56","1461"
201920,"Ipswich","LADU","Level 3","339","68","174","58","12","651"
201920,"Ipswich","LADU","Level 2","145","60","137","71","14","427"
201920,"Ipswich","LADU","All other qualifications","104","51","85","113","30","383"
202021,"Ipswich","LADU","Total","697","125","373","256","51","1502"
202021,"Ipswich","LADU","Level 3","391","34","177","59","22","683"
202021,"Ipswich","LADU","Level 2","205","46","116","70","10","447"
202021,"Ipswich","LADU","All other qualifications","101","45","80","127","19","372"
201718,"King's Lynn and West Norfolk","LADU","Total","513","199","698","341","122","1873"
201718,"King's Lynn and West Norfolk","LADU","Level 3","428","89","393","105","39","1054"
201718,"King's Lynn and West Norfolk","LADU","Level 2","39","63","182","84","26","394"
201718,"King's Lynn and West Norfolk","LADU","All other qualifications","46","47","123","152","57","425"
201819,"King's Lynn and West Norfolk","LADU","Total","506","198","723","352","132","1911"
201819,"King's Lynn and West Norfolk","LADU","Level 3","392","63","297","81","26","859"
201819,"King's Lynn and West Norfolk","LADU","Level 2","78","106","313","130","54","681"
201819,"King's Lynn and West Norfolk","LADU","All other qualifications","36","29","113","141","52","371"
201920,"King's Lynn and West Norfolk","LADU","Total","514","190","608","291","101","1704"
201920,"King's Lynn and West Norfolk","LADU","Level 3","379","58","291","86","24","838"
201920,"King's Lynn and West Norfolk","LADU","Level 2","70","99","199","92","37","497"
201920,"King's Lynn and West Norfolk","LADU","All other qualifications","65","33","118","113","40","369"
202021,"King's Lynn and West Norfolk","LADU","Total","632","155","566","371","96","1820"
202021,"King's Lynn and West Norfolk","LADU","Level 3","407","56","252","107","25","847"
202021,"King's Lynn and West Norfolk","LADU","Level 2","158","55","187","117","35","552"
202021,"King's Lynn and West Norfolk","LADU","All other qualifications","67","44","127","147","36","421"
201718,"Luton","LADU","Total","1258","158","397","231","136","2180"
201718,"Luton","LADU","Level 3","1086","98","259","112","57","1612"
201718,"Luton","LADU","Level 2","90","27","78","48","18","261"
201718,"Luton","LADU","All other qualifications","82","33","60","71","61","307"
201819,"Luton","LADU","Total","1232","129","410","247","113","2131"
201819,"Luton","LADU","Level 3","891","70","258","109","49","1377"
201819,"Luton","LADU","Level 2","247","28","75","42","10","402"
201819,"Luton","LADU","All other qualifications","94","31","77","96","54","352"
201920,"Luton","LADU","Total","1231","100","406","262","118","2117"
201920,"Luton","LADU","Level 3","925","57","275","125","47","1429"
201920,"Luton","LADU","Level 2","233","18","62","50","26","389"
201920,"Luton","LADU","All other qualifications","73","25","69","87","45","299"
202021,"Luton","LADU","Total","1084","75","300","259","76","1794"
202021,"Luton","LADU","Level 3","923","40","223","183","48","1417"
202021,"Luton","LADU","Level 2","154","12","34","32","11","243"
202021,"Luton","LADU","All other qualifications","7","23","43","44","17","134"
201718,"Maldon","LADU","Total","86","33","69","24","8","220"
201718,"Maldon","LADU","Level 3","86","27","63","19","6","201"
201718,"Maldon","LADU","Level 2","0","4","6","4","0","14"
201718,"Maldon","LADU","All other qualifications","0","2","0","1","2","5"
201819,"Maldon","LADU","Total","91","26","58","7","7","189"
201819,"Maldon","LADU","Level 3","91","20","53","5","5","174"
201819,"Maldon","LADU","Level 2","0","5","5","1","1","12"
201819,"Maldon","LADU","All other qualifications","0","1","0","1","1","3"
201920,"Maldon","LADU","Total","73","22","61","16","8","180"
201920,"Maldon","LADU","Level 3","73","17","51","10","4","155"
201920,"Maldon","LADU","Level 2","0","4","9","6","2","21"
201920,"Maldon","LADU","All other qualifications","0","1","1","0","2","4"
202021,"Maldon","LADU","Total","93","21","45","24","6","189"
202021,"Maldon","LADU","Level 3","92","16","42","20","4","174"
202021,"Maldon","LADU","Level 2","1","5","3","2","2","13"
202021,"Maldon","LADU","All other qualifications","0","0","0","2","0","2"
201718,"Mid Suffolk","LADU","Total","224","29","85","20","4","362"
201718,"Mid Suffolk","LADU","Level 3","224","29","83","19","4","359"
201718,"Mid Suffolk","LADU","Level 2","0","0","2","0","0","2"
201718,"Mid Suffolk","LADU","All other qualifications","0","0","0","1","0","1"
201819,"Mid Suffolk","LADU","Total","209","27","93","26","11","366"
201819,"Mid Suffolk","LADU","Level 3","207","24","92","24","9","356"
201819,"Mid Suffolk","LADU","Level 2","2","1","0","1","0","4"
201819,"Mid Suffolk","LADU","All other qualifications","0","2","1","1","2","6"
201920,"Mid Suffolk","LADU","Total","145","33","94","21","11","304"
201920,"Mid Suffolk","LADU","Level 3","144","31","89","17","10","291"
201920,"Mid Suffolk","LADU","Level 2","0","1","0","0","0","1"
201920,"Mid Suffolk","LADU","All other qualifications","1","1","5","4","1","12"
202021,"Mid Suffolk","LADU","Total","174","10","66","25","11","286"
202021,"Mid Suffolk","LADU","Level 3","171","8","66","20","11","276"
202021,"Mid Suffolk","LADU","Level 2","1","0","0","1","0","2"
202021,"Mid Suffolk","LADU","All other qualifications","2","2","0","4","0","8"
201718,"North Hertfordshire","LADU","Total","585","150","561","223","92","1611"
201718,"North Hertfordshire","LADU","Level 3","499","60","303","69","33","964"
201718,"North Hertfordshire","LADU","Level 2","27","42","127","46","16","258"
201718,"North Hertfordshire","LADU","All other qualifications","59","48","131","108","43","389"
201819,"North Hertfordshire","LADU","Total","403","32","133","51","15","634"
201819,"North Hertfordshire","LADU","Level 3","401","26","124","45","12","608"
201819,"North Hertfordshire","LADU","Level 2","1","2","7","4","2","16"
201819,"North Hertfordshire","LADU","All other qualifications","1","4","2","2","1","10"
201920,"North Hertfordshire","LADU","Total","390","35","145","49","18","637"
201920,"North Hertfordshire","LADU","Level 3","389","34","141","45","14","623"
201920,"North Hertfordshire","LADU","Level 2","0","0","0","0","1","1"
201920,"North Hertfordshire","LADU","All other qualifications","1","1","4","4","3","13"
202021,"North Hertfordshire","LADU","Total","388","19","141","34","22","604"
202021,"North Hertfordshire","LADU","Level 3","387","15","128","31","20","581"
202021,"North Hertfordshire","LADU","Level 2","0","2","6","3","1","12"
202021,"North Hertfordshire","LADU","All other qualifications","1","2","7","0","1","11"
201718,"North Norfolk","LADU","Total","243","40","142","55","21","501"
201718,"North Norfolk","LADU","Level 3","243","31","125","43","19","461"
201718,"North Norfolk","LADU","Level 2","0","2","6","4","1","13"
201718,"North Norfolk","LADU","All other qualifications","0","7","11","8","1","27"
201819,"North Norfolk","LADU","Total","67","15","45","12","8","147"
201819,"North Norfolk","LADU","Level 3","66","10","37","9","7","129"
201819,"North Norfolk","LADU","Level 2","0","2","5","1","1","9"
201819,"North Norfolk","LADU","All other qualifications","1","3","3","2","0","9"
201920,"North Norfolk","LADU","Total","65","22","37","14","9","147"
201920,"North Norfolk","LADU","Level 3","55","10","22","11","6","104"
201920,"North Norfolk","LADU","Level 2","1","2","5","1","3","12"
201920,"North Norfolk","LADU","All other qualifications","9","10","10","2","0","31"
202021,"North Norfolk","LADU","Total","69","11","42","26","1","149"
202021,"North Norfolk","LADU","Level 3","66","7","34","19","1","127"
202021,"North Norfolk","LADU","Level 2","1","1","6","2","0","10"
202021,"North Norfolk","LADU","All other qualifications","2","3","2","5","0","12"
201718,"Norwich","LADU","Total","854","269","863","408","149","2543"
201718,"Norwich","LADU","Level 3","704","104","484","148","53","1493"
201718,"Norwich","LADU","Level 2","82","109","264","120","47","622"
201718,"Norwich","LADU","All other qualifications","68","56","115","140","49","428"
201819,"Norwich","LADU","Total","957","331","1086","455","146","2975"
201819,"Norwich","LADU","Level 3","771","124","592","149","57","1693"
201819,"Norwich","LADU","Level 2","136","136","373","168","47","860"
201819,"Norwich","LADU","All other qualifications","50","71","121","138","42","422"
201920,"Norwich","LADU","Total","1114","248","998","531","143","3034"
201920,"Norwich","LADU","Level 3","899","113","584","215","77","1888"
201920,"Norwich","LADU","Level 2","122","91","272","146","22","653"
201920,"Norwich","LADU","All other qualifications","93","44","142","170","44","493"
202021,"Norwich","LADU","Total","1439","234","995","549","160","3377"
202021,"Norwich","LADU","Level 3","1057","81","626","243","76","2083"
202021,"Norwich","LADU","Level 2","222","64","219","146","37","688"
202021,"Norwich","LADU","All other qualifications","160","89","150","160","47","606"
201718,"Peterborough","LADU","Total","1164","218","769","329","180","2660"
201718,"Peterborough","LADU","Level 3","839","102","412","104","62","1519"
201718,"Peterborough","LADU","Level 2","205","52","170","76","37","540"
201718,"Peterborough","LADU","All other qualifications","120","64","187","149","81","601"
201819,"Peterborough","LADU","Total","1004","227","700","396","172","2499"
201819,"Peterborough","LADU","Level 3","826","96","306","108","60","1396"
201819,"Peterborough","LADU","Level 2","93","61","191","98","35","478"
201819,"Peterborough","LADU","All other qualifications","85","70","203","190","77","625"
201920,"Peterborough","LADU","Total","1198","215","757","379","146","2695"
201920,"Peterborough","LADU","Level 3","918","74","382","112","40","1526"
201920,"Peterborough","LADU","Level 2","146","57","189","103","24","519"
201920,"Peterborough","LADU","All other qualifications","134","84","186","164","82","650"
202021,"Peterborough","LADU","Total","1278","125","611","418","128","2560"
202021,"Peterborough","LADU","Level 3","995","53","312","161","38","1559"
202021,"Peterborough","LADU","Level 2","157","32","138","84","25","436"
202021,"Peterborough","LADU","All other qualifications","126","40","161","173","65","565"
201718,"Rochford","LADU","Total","166","44","104","31","15","360"
201718,"Rochford","LADU","Level 3","157","40","96","24","12","329"
201718,"Rochford","LADU","Level 2","9","2","5","5","3","24"
201718,"Rochford","LADU","All other qualifications","0","2","3","2","0","7"
201819,"Rochford","LADU","Total","201","47","121","37","11","417"
201819,"Rochford","LADU","Level 3","199","40","114","33","7","393"
201819,"Rochford","LADU","Level 2","2","4","7","3","3","19"
201819,"Rochford","LADU","All other qualifications","0","3","0","1","1","5"
201920,"Rochford","LADU","Total","204","59","105","29","12","409"
201920,"Rochford","LADU","Level 3","203","55","95","25","11","389"
201920,"Rochford","LADU","Level 2","0","3","4","3","0","10"
201920,"Rochford","LADU","All other qualifications","1","1","6","1","1","10"
202021,"Rochford","LADU","Total","234","35","105","36","8","418"
202021,"Rochford","LADU","Level 3","225","33","96","33","5","392"
202021,"Rochford","LADU","Level 2","4","1","6","1","3","15"
202021,"Rochford","LADU","All other qualifications","5","1","3","2","0","11"
201718,"South Cambridgeshire","LADU","Total","477","179","607","230","185","1678"
201718,"South Cambridgeshire","LADU","Level 3","290","58","314","56","51","769"
201718,"South Cambridgeshire","LADU","Level 2","133","55","161","63","42","454"
201718,"South Cambridgeshire","LADU","All other qualifications","54","66","132","111","92","455"
201819,"South Cambridgeshire","LADU","Total","497","213","700","258","202","1870"
201819,"South Cambridgeshire","LADU","Level 3","255","32","245","60","33","625"
201819,"South Cambridgeshire","LADU","Level 2","156","106","280","76","84","702"
201819,"South Cambridgeshire","LADU","All other qualifications","86","75","175","122","85","543"
201920,"South Cambridgeshire","LADU","Total","617","144","715","287","145","1908"
201920,"South Cambridgeshire","LADU","Level 3","421","39","339","71","50","920"
201920,"South Cambridgeshire","LADU","Level 2","108","56","210","78","37","489"
201920,"South Cambridgeshire","LADU","All other qualifications","88","49","166","138","58","499"
202021,"South Cambridgeshire","LADU","Total","711","150","585","315","146","1907"
202021,"South Cambridgeshire","LADU","Level 3","473","28","257","82","68","908"
202021,"South Cambridgeshire","LADU","Level 2","128","44","169","68","26","435"
202021,"South Cambridgeshire","LADU","All other qualifications","110","78","159","165","52","564"
201718,"South Norfolk","LADU","Total","524","136","556","232","109","1557"
201718,"South Norfolk","LADU","Level 3","431","50","307","88","45","921"
201718,"South Norfolk","LADU","Level 2","50","50","160","58","30","348"
201718,"South Norfolk","LADU","All other qualifications","43","36","89","86","34","288"
201819,"South Norfolk","LADU","Total","445","138","458","246","97","1384"
201819,"South Norfolk","LADU","Level 3","386","63","252","78","46","825"
201819,"South Norfolk","LADU","Level 2","36","38","118","65","21","278"
201819,"South Norfolk","LADU","All other qualifications","23","37","88","103","30","281"
201920,"South Norfolk","LADU","Total","435","130","477","263","89","1394"
201920,"South Norfolk","LADU","Level 3","358","35","247","97","40","777"
201920,"South Norfolk","LADU","Level 2","30","42","139","63","25","299"
201920,"South Norfolk","LADU","All other qualifications","47","53","91","103","24","318"
202021,"South Norfolk","LADU","Total","362","86","245","140","64","897"
202021,"South Norfolk","LADU","Level 3","336","17","119","43","20","535"
202021,"South Norfolk","LADU","Level 2","16","26","63","30","17","152"
202021,"South Norfolk","LADU","All other qualifications","10","43","63","67","27","210"
201718,"Southend-on-Sea","LADU","Total","1251","334","1208","569","281","3643"
201718,"Southend-on-Sea","LADU","Level 3","1153","189","813","257","128","2540"
201718,"Southend-on-Sea","LADU","Level 2","57","73","208","120","45","503"
201718,"Southend-on-Sea","LADU","All other qualifications","41","72","187","192","108","600"
201819,"Southend-on-Sea","LADU","Total","1132","244","791","445","195","2807"
201819,"Southend-on-Sea","LADU","Level 3","929","119","377","161","64","1650"
201819,"Southend-on-Sea","LADU","Level 2","149","55","262","142","58","666"
201819,"Southend-on-Sea","LADU","All other qualifications","54","70","152","142","73","491"
201920,"Southend-on-Sea","LADU","Total","1195","271","1009","548","238","3261"
201920,"Southend-on-Sea","LADU","Level 3","1078","137","601","216","85","2117"
201920,"Southend-on-Sea","LADU","Level 2","75","67","218","151","56","567"
201920,"Southend-on-Sea","LADU","All other qualifications","42","67","190","181","97","577"
202021,"Southend-on-Sea","LADU","Total","2015","350","1536","965","289","5155"
202021,"Southend-on-Sea","LADU","Level 3","1663","147","888","404","132","3234"
202021,"Southend-on-Sea","LADU","Level 2","221","98","359","272","69","1019"
202021,"Southend-on-Sea","LADU","All other qualifications","131","105","289","289","88","902"
201718,"St Albans","LADU","Total","1451","201","659","296","142","2749"
201718,"St Albans","LADU","Level 3","1228","87","438","128","69","1950"
201718,"St Albans","LADU","Level 2","132","64","126","73","29","424"
201718,"St Albans","LADU","All other qualifications","91","50","95","95","44","375"
201819,"St Albans","LADU","Total","1311","209","666","278","147","2611"
201819,"St Albans","LADU","Level 3","1216","91","421","106","58","1892"
201819,"St Albans","LADU","Level 2","69","83","161","93","44","450"
201819,"St Albans","LADU","All other qualifications","26","35","84","79","45","269"
201920,"St Albans","LADU","Total","1580","209","734","359","141","3023"
201920,"St Albans","LADU","Level 3","1368","107","498","157","73","2203"
201920,"St Albans","LADU","Level 2","85","66","156","95","32","434"
201920,"St Albans","LADU","All other qualifications","127","36","80","107","36","386"
202021,"St Albans","LADU","Total","1684","128","596","326","150","2884"
202021,"St Albans","LADU","Level 3","1388","53","373","139","71","2024"
202021,"St Albans","LADU","Level 2","176","48","131","83","29","467"
202021,"St Albans","LADU","All other qualifications","120","27","92","104","50","393"
201718,"St Edmundsbury","LADU","Total","772","212","648","220","113","1965"
201718,"St Edmundsbury","LADU","Level 3","589","79","350","77","39","1134"
201718,"St Edmundsbury","LADU","Level 2","121","70","181","47","31","450"
201718,"St Edmundsbury","LADU","All other qualifications","62","63","117","96","43","381"
201819,"St Edmundsbury","LADU","Total","755","192","667","268","103","1985"
201819,"St Edmundsbury","LADU","Level 3","489","61","338","79","41","1008"
201819,"St Edmundsbury","LADU","Level 2","217","80","209","81","37","624"
201819,"St Edmundsbury","LADU","All other qualifications","49","51","120","108","25","353"
201718,"Stevenage","LADU","Total","365","49","132","29","15","590"
201718,"Stevenage","LADU","Level 3","363","43","123","26","13","568"
201718,"Stevenage","LADU","Level 2","1","3","8","2","1","15"
201718,"Stevenage","LADU","All other qualifications","1","3","1","1","1","7"
201819,"Stevenage","LADU","Total","617","180","570","279","101","1747"
201819,"Stevenage","LADU","Level 3","460","58","253","82","28","881"
201819,"Stevenage","LADU","Level 2","92","75","200","69","22","458"
201819,"Stevenage","LADU","All other qualifications","65","47","117","128","51","408"
201920,"Stevenage","LADU","Total","578","160","601","264","88","1691"
201920,"Stevenage","LADU","Level 3","432","56","299","73","32","892"
201920,"Stevenage","LADU","Level 2","80","48","178","59","13","378"
201920,"Stevenage","LADU","All other qualifications","66","56","124","132","43","421"
202021,"Stevenage","LADU","Total","596","94","443","253","86","1472"
202021,"Stevenage","LADU","Level 3","454","24","230","86","29","823"
202021,"Stevenage","LADU","Level 2","81","33","100","49","16","279"
202021,"Stevenage","LADU","All other qualifications","61","37","113","118","41","370"
201718,"Suffolk Coastal","LADU","Total","370","48","151","39","21","629"
201718,"Suffolk Coastal","LADU","Level 3","368","45","147","33","14","607"
201718,"Suffolk Coastal","LADU","Level 2","2","2","3","4","4","15"
201718,"Suffolk Coastal","LADU","All other qualifications","0","1","1","2","3","7"
201819,"Suffolk Coastal","LADU","Total","329","57","138","35","16","575"
201819,"Suffolk Coastal","LADU","Level 3","328","53","124","28","14","547"
201819,"Suffolk Coastal","LADU","Level 2","1","1","8","5","2","17"
201819,"Suffolk Coastal","LADU","All other qualifications","0","3","6","2","0","11"
201718,"Tendring","LADU","Total","225","65","173","112","34","609"
201718,"Tendring","LADU","Level 3","220","52","147","77","21","517"
201718,"Tendring","LADU","Level 2","3","4","14","20","6","47"
201718,"Tendring","LADU","All other qualifications","2","9","12","15","7","45"
201819,"Tendring","LADU","Total","170","67","138","96","27","498"
201819,"Tendring","LADU","Level 3","161","52","114","69","20","416"
201819,"Tendring","LADU","Level 2","8","6","17","13","4","48"
201819,"Tendring","LADU","All other qualifications","1","9","7","14","3","34"
201920,"Tendring","LADU","Total","144","25","111","67","15","362"
201920,"Tendring","LADU","Level 3","139","14","88","38","8","287"
201920,"Tendring","LADU","Level 2","4","6","16","21","4","51"
201920,"Tendring","LADU","All other qualifications","1","5","7","8","3","24"
202021,"Tendring","LADU","Total","161","29","89","78","12","369"
202021,"Tendring","LADU","Level 3","150","19","75","61","9","314"
202021,"Tendring","LADU","Level 2","10","5","9","8","1","33"
202021,"Tendring","LADU","All other qualifications","1","5","5","9","2","22"
201718,"Three Rivers","LADU","Total","473","19","125","46","19","682"
201718,"Three Rivers","LADU","Level 3","470","19","125","46","18","678"
201718,"Three Rivers","LADU","Level 2","3","0","0","0","1","4"
201819,"Three Rivers","LADU","Total","472","25","119","18","18","652"
201819,"Three Rivers","LADU","Level 3","468","22","118","18","18","644"
201819,"Three Rivers","LADU","Level 2","3","1","1","0","0","5"
201819,"Three Rivers","LADU","All other qualifications","1","2","0","0","0","3"
201920,"Three Rivers","LADU","Total","472","30","85","29","21","637"
201920,"Three Rivers","LADU","Level 3","465","29","82","28","20","624"
201920,"Three Rivers","LADU","Level 2","2","0","0","1","0","3"
201920,"Three Rivers","LADU","All other qualifications","5","1","3","0","1","10"
202021,"Three Rivers","LADU","Total","508","17","100","39","23","687"
202021,"Three Rivers","LADU","Level 3","507","14","94","35","21","671"
202021,"Three Rivers","LADU","All other qualifications","1","3","6","4","2","16"
201718,"Thurrock","LADU","Total","586","133","338","102","38","1197"
201718,"Thurrock","LADU","Level 3","585","100","299","80","31","1095"
201718,"Thurrock","LADU","Level 2","1","11","19","8","1","40"
201718,"Thurrock","LADU","All other qualifications","0","22","20","14","6","62"
201819,"Thurrock","LADU","Total","172","47","94","48","23","384"
201819,"Thurrock","LADU","Level 3","160","27","72","28","6","293"
201819,"Thurrock","LADU","Level 2","6","6","11","12","6","41"
201819,"Thurrock","LADU","All other qualifications","6","14","11","8","11","50"
201920,"Thurrock","LADU","Total","170","39","117","46","15","387"
201920,"Thurrock","LADU","Level 3","167","24","85","25","9","310"
201920,"Thurrock","LADU","Level 2","0","4","9","5","1","19"
201920,"Thurrock","LADU","All other qualifications","3","11","23","16","5","58"
202021,"Thurrock","LADU","Total","212","16","86","37","9","360"
202021,"Thurrock","LADU","Level 3","204","9","73","33","6","325"
202021,"Thurrock","LADU","Level 2","2","1","3","0","2","8"
202021,"Thurrock","LADU","All other qualifications","6","6","10","4","1","27"
201718,"Uttlesford","LADU","Total","276","16","98","23","14","427"
201718,"Uttlesford","LADU","Level 3","276","14","96","22","13","421"
201718,"Uttlesford","LADU","Level 2","0","2","1","1","0","4"
201718,"Uttlesford","LADU","All other qualifications","0","0","1","0","1","2"
201819,"Uttlesford","LADU","Total","222","32","124","29","17","424"
201819,"Uttlesford","LADU","Level 3","221","28","121","26","16","412"
201819,"Uttlesford","LADU","Level 2","0","3","2","1","1","7"
201819,"Uttlesford","LADU","All other qualifications","1","1","1","2","0","5"
201920,"Uttlesford","LADU","Total","249","21","104","40","11","425"
201920,"Uttlesford","LADU","Level 3","243","20","101","37","10","411"
201920,"Uttlesford","LADU","Level 2","6","1","2","0","0","9"
201920,"Uttlesford","LADU","All other qualifications","0","0","1","3","1","5"
202021,"Uttlesford","LADU","Total","261","8","103","33","12","417"
202021,"Uttlesford","LADU","Level 3","259","7","98","32","11","407"
202021,"Uttlesford","LADU","Level 2","2","1","3","1","0","7"
202021,"Uttlesford","LADU","All other qualifications","0","0","2","0","1","3"
201718,"Watford","LADU","Total","1227","162","701","307","117","2514"
201718,"Watford","LADU","Level 3","859","51","356","89","40","1395"
201718,"Watford","LADU","Level 2","295","67","212","102","34","710"
201718,"Watford","LADU","All other qualifications","73","44","133","116","43","409"
201819,"Watford","LADU","Total","1185","198","684","314","128","2509"
201819,"Watford","LADU","Level 3","793","57","331","95","46","1322"
201819,"Watford","LADU","Level 2","337","94","239","115","48","833"
201819,"Watford","LADU","All other qualifications","55","47","114","104","34","354"
201920,"Watford","LADU","Total","1204","180","790","333","153","2660"
201920,"Watford","LADU","Level 3","951","64","464","119","53","1651"
201920,"Watford","LADU","Level 2","186","74","203","100","47","610"
201920,"Watford","LADU","All other qualifications","67","42","123","114","53","399"
202021,"Watford","LADU","Total","1581","151","703","565","192","3192"
202021,"Watford","LADU","Level 3","1011","55","382","239","82","1769"
202021,"Watford","LADU","Level 2","387","55","187","132","50","811"
202021,"Watford","LADU","All other qualifications","183","41","134","194","60","612"
201718,"Waveney","LADU","Total","338","121","323","156","62","1000"
201718,"Waveney","LADU","Level 3","226","52","181","51","28","538"
201718,"Waveney","LADU","Level 2","72","49","92","47","12","272"
201718,"Waveney","LADU","All other qualifications","40","20","50","58","22","190"
201819,"Waveney","LADU","Total","351","127","335","222","57","1092"
201819,"Waveney","LADU","Level 3","274","52","167","72","29","594"
201819,"Waveney","LADU","Level 2","50","48","104","82","12","296"
201819,"Waveney","LADU","All other qualifications","27","27","64","68","16","202"
201718,"Welwyn Hatfield","LADU","Total","246","28","89","30","10","403"
201718,"Welwyn Hatfield","LADU","Level 3","246","28","87","29","8","398"
201718,"Welwyn Hatfield","LADU","Level 2","0","0","1","1","1","3"
201718,"Welwyn Hatfield","LADU","All other qualifications","0","0","1","0","1","2"
201819,"Welwyn Hatfield","LADU","Total","296","28","75","28","9","436"
201819,"Welwyn Hatfield","LADU","Level 3","292","26","71","24","6","419"
201819,"Welwyn Hatfield","LADU","Level 2","4","1","3","0","2","10"
201819,"Welwyn Hatfield","LADU","All other qualifications","0","1","1","4","1","7"
201920,"Welwyn Hatfield","LADU","Total","245","28","75","26","10","384"
201920,"Welwyn Hatfield","LADU","Level 3","244","25","71","24","10","374"
201920,"Welwyn Hatfield","LADU","Level 2","0","0","2","0","0","2"
201920,"Welwyn Hatfield","LADU","All other qualifications","1","3","2","2","0","8"
202021,"Welwyn Hatfield","LADU","Total","282","10","65","36","17","410"
202021,"Welwyn Hatfield","LADU","Level 3","280","9","62","32","16","399"
202021,"Welwyn Hatfield","LADU","Level 2","1","0","0","0","0","1"
202021,"Welwyn Hatfield","LADU","All other qualifications","1","1","3","4","1","10"
201920,"West Suffolk","LADU","Total","773","179","703","264","81","2000"
201920,"West Suffolk","LADU","Level 3","625","77","394","92","37","1225"
201920,"West Suffolk","LADU","Level 2","70","54","177","57","16","374"
201920,"West Suffolk","LADU","All other qualifications","78","48","132","115","28","401"
202021,"West Suffolk","LADU","Total","749","166","629","313","78","1935"
202021,"West Suffolk","LADU","Level 3","565","57","357","120","24","1123"
202021,"West Suffolk","LADU","Level 2","127","58","171","72","23","451"
202021,"West Suffolk","LADU","All other qualifications","57","51","101","121","31","361"
201718,"Barking and Dagenham","LADU","Total","1104","222","513","404","253","2496"
201718,"Barking and Dagenham","LADU","Level 3","777","82","260","140","81","1340"
201718,"Barking and Dagenham","LADU","Level 2","168","70","121","83","40","482"
201718,"Barking and Dagenham","LADU","All other qualifications","159","70","132","181","132","674"
201819,"Barking and Dagenham","LADU","Total","1218","188","439","381","184","2410"
201819,"Barking and Dagenham","LADU","Level 3","857","72","177","129","62","1297"
201819,"Barking and Dagenham","LADU","Level 2","178","43","124","72","28","445"
201819,"Barking and Dagenham","LADU","All other qualifications","183","73","138","180","94","668"
201920,"Barking and Dagenham","LADU","Total","1321","160","435","406","191","2513"
201920,"Barking and Dagenham","LADU","Level 3","968","65","236","140","77","1486"
201920,"Barking and Dagenham","LADU","Level 2","151","42","80","73","25","371"
201920,"Barking and Dagenham","LADU","All other qualifications","202","53","119","193","89","656"
202021,"Barking and Dagenham","LADU","Total","1352","99","302","417","176","2346"
202021,"Barking and Dagenham","LADU","Level 3","943","31","144","127","64","1309"
202021,"Barking and Dagenham","LADU","Level 2","183","22","67","92","23","387"
202021,"Barking and Dagenham","LADU","All other qualifications","226","46","91","198","89","650"
201718,"Barnet","LADU","Total","2757","140","617","435","409","4358"
201718,"Barnet","LADU","Level 3","2428","78","464","255","258","3483"
201718,"Barnet","LADU","Level 2","209","33","78","67","51","438"
201718,"Barnet","LADU","All other qualifications","120","29","75","113","100","437"
201819,"Barnet","LADU","Total","2736","110","573","458","349","4226"
201819,"Barnet","LADU","Level 3","2309","47","403","241","220","3220"
201819,"Barnet","LADU","Level 2","299","35","98","94","51","577"
201819,"Barnet","LADU","All other qualifications","128","28","72","123","78","429"
201920,"Barnet","LADU","Total","2679","84","563","475","364","4165"
201920,"Barnet","LADU","Level 3","2426","44","434","265","230","3399"
201920,"Barnet","LADU","Level 2","99","18","54","76","29","276"
201920,"Barnet","LADU","All other qualifications","154","22","75","134","105","490"
202021,"Barnet","LADU","Total","2991","75","437","524","372","4399"
202021,"Barnet","LADU","Level 3","2604","40","302","296","245","3487"
202021,"Barnet","LADU","Level 2","177","14","57","60","34","342"
202021,"Barnet","LADU","All other qualifications","210","21","78","168","93","570"
201718,"Bexley","LADU","Total","1090","172","326","191","104","1883"
201718,"Bexley","LADU","Level 3","1087","113","266","106","61","1633"
201718,"Bexley","LADU","Level 2","3","25","28","31","16","103"
201718,"Bexley","LADU","All other qualifications","0","34","32","54","27","147"
201819,"Bexley","LADU","Total","1074","202","356","152","114","1898"
201819,"Bexley","LADU","Level 3","1058","128","300","101","68","1655"
201819,"Bexley","LADU","Level 2","11","32","26","12","15","96"
201819,"Bexley","LADU","All other qualifications","5","42","30","39","31","147"
201920,"Bexley","LADU","Total","988","155","405","125","57","1730"
201920,"Bexley","LADU","Level 3","966","110","363","98","49","1586"
201920,"Bexley","LADU","Level 2","14","16","21","13","4","68"
201920,"Bexley","LADU","All other qualifications","8","29","21","14","4","76"
202021,"Bexley","LADU","Total","1191","105","243","176","66","1781"
202021,"Bexley","LADU","Level 3","1172","78","217","155","58","1680"
202021,"Bexley","LADU","Level 2","12","9","13","15","6","55"
202021,"Bexley","LADU","All other qualifications","7","18","13","6","2","46"
201718,"Brent","LADU","Total","1428","86","251","207","162","2134"
201718,"Brent","LADU","Level 3","1202","37","129","98","72","1538"
201718,"Brent","LADU","Level 2","114","17","53","32","36","252"
201718,"Brent","LADU","All other qualifications","112","32","69","77","54","344"
201819,"Brent","LADU","Total","1084","52","204","174","159","1673"
201819,"Brent","LADU","Level 3","1037","22","148","94","93","1394"
201819,"Brent","LADU","Level 2","37","18","32","20","28","135"
201819,"Brent","LADU","All other qualifications","10","12","24","60","38","144"
201920,"Brent","LADU","Total","1176","61","163","137","139","1676"
201920,"Brent","LADU","Level 3","1112","39","134","88","89","1462"
201920,"Brent","LADU","Level 2","44","9","13","23","18","107"
201920,"Brent","LADU","All other qualifications","20","13","16","26","32","107"
202021,"Brent","LADU","Total","1267","27","103","143","117","1657"
202021,"Brent","LADU","Level 3","1179","18","91","118","98","1504"
202021,"Brent","LADU","Level 2","49","4","8","10","5","76"
202021,"Brent","LADU","All other qualifications","39","5","4","15","14","77"
201718,"Bromley","LADU","Total","1984","331","958","530","291","4094"
201718,"Bromley","LADU","Level 3","1836","174","701","272","117","3100"
201718,"Bromley","LADU","Level 2","59","70","115","76","50","370"
201718,"Bromley","LADU","All other qualifications","89","87","142","182","124","624"
201819,"Bromley","LADU","Total","2057","401","1212","696","365","4731"
201819,"Bromley","LADU","Level 3","1759","192","745","261","144","3101"
201819,"Bromley","LADU","Level 2","166","118","253","156","80","773"
201819,"Bromley","LADU","All other qualifications","132","91","214","279","141","857"
201920,"Bromley","LADU","Total","2143","389","1105","701","370","4708"
201920,"Bromley","LADU","Level 3","1851","188","712","286","142","3179"
201920,"Bromley","LADU","Level 2","98","86","159","121","71","535"
201920,"Bromley","LADU","All other qualifications","194","115","234","294","157","994"
202021,"Bromley","LADU","Total","2364","296","857","764","364","4645"
202021,"Bromley","LADU","Level 3","1931","119","523","336","162","3071"
202021,"Bromley","LADU","Level 2","197","83","145","146","62","633"
202021,"Bromley","LADU","All other qualifications","236","94","189","282","140","941"
201718,"Camden","LADU","Total","2113","136","647","400","303","3599"
201718,"Camden","LADU","Level 3","1850","66","435","249","164","2764"
201718,"Camden","LADU","Level 2","85","47","111","50","30","323"
201718,"Camden","LADU","All other qualifications","178","23","101","101","109","512"
201819,"Camden","LADU","Total","2844","162","888","676","310","4880"
201819,"Camden","LADU","Level 3","2124","87","587","343","144","3285"
201819,"Camden","LADU","Level 2","502","35","148","150","71","906"
201819,"Camden","LADU","All other qualifications","218","40","153","183","95","689"
201920,"Camden","LADU","Total","2699","153","862","716","347","4777"
201920,"Camden","LADU","Level 3","2245","73","570","330","165","3383"
201920,"Camden","LADU","Level 2","240","36","123","129","58","586"
201920,"Camden","LADU","All other qualifications","214","44","169","257","124","808"
202021,"Camden","LADU","Total","3211","132","754","1096","418","5611"
202021,"Camden","LADU","Level 3","2430","42","391","513","188","3564"
202021,"Camden","LADU","Level 2","439","35","137","198","61","870"
202021,"Camden","LADU","All other qualifications","342","55","226","385","169","1177"
201718,"Croydon","LADU","Total","1725","144","645","393","253","3160"
201718,"Croydon","LADU","Level 3","1511","84","466","210","105","2376"
201718,"Croydon","LADU","Level 2","124","30","74","72","27","327"
201718,"Croydon","LADU","All other qualifications","90","30","105","111","121","457"
201819,"Croydon","LADU","Total","1754","146","713","483","251","3347"
201819,"Croydon","LADU","Level 3","1502","83","483","229","127","2424"
201819,"Croydon","LADU","Level 2","167","30","126","101","42","466"
201819,"Croydon","LADU","All other qualifications","85","33","104","153","82","457"
201920,"Croydon","LADU","Total","1803","95","655","499","210","3262"
201920,"Croydon","LADU","Level 3","1530","51","462","224","120","2387"
201920,"Croydon","LADU","Level 2","131","16","72","79","23","321"
201920,"Croydon","LADU","All other qualifications","142","28","121","196","67","554"
202021,"Croydon","LADU","Total","1957","81","442","609","237","3326"
202021,"Croydon","LADU","Level 3","1676","41","289","340","147","2493"
202021,"Croydon","LADU","Level 2","152","13","68","94","28","355"
202021,"Croydon","LADU","All other qualifications","129","27","85","175","62","478"
201718,"Ealing","LADU","Total","1235","55","194","160","91","1735"
201718,"Ealing","LADU","Level 3","1211","47","185","143","71","1657"
201718,"Ealing","LADU","Level 2","23","5","3","11","9","51"
201718,"Ealing","LADU","All other qualifications","1","3","6","6","11","27"
201819,"Ealing","LADU","Total","1277","68","189","136","79","1749"
201819,"Ealing","LADU","Level 3","1250","53","170","119","72","1664"
201819,"Ealing","LADU","Level 2","25","12","13","11","5","66"
201819,"Ealing","LADU","All other qualifications","2","3","6","6","2","19"
201920,"Ealing","LADU","Total","1267","36","232","123","101","1759"
201920,"Ealing","LADU","Level 3","1228","23","214","103","81","1649"
201920,"Ealing","LADU","Level 2","28","10","9","10","14","71"
201920,"Ealing","LADU","All other qualifications","11","3","9","10","6","39"
202021,"Ealing","LADU","Total","1444","31","135","179","115","1904"
202021,"Ealing","LADU","Level 3","1397","19","122","154","101","1793"
202021,"Ealing","LADU","Level 2","24","8","9","11","10","62"
202021,"Ealing","LADU","All other qualifications","23","4","4","14","4","49"
201718,"Enfield","LADU","Total","1308","90","292","210","128","2028"
201718,"Enfield","LADU","Level 3","1219","51","208","125","74","1677"
201718,"Enfield","LADU","Level 2","66","25","52","46","23","212"
201718,"Enfield","LADU","All other qualifications","23","14","32","39","31","139"
201819,"Enfield","LADU","Total","1478","63","295","222","128","2186"
201819,"Enfield","LADU","Level 3","1347","41","229","124","74","1815"
201819,"Enfield","LADU","Level 2","107","12","49","53","36","257"
201819,"Enfield","LADU","All other qualifications","24","10","17","45","18","114"
201920,"Enfield","LADU","Total","1281","68","291","178","120","1938"
201920,"Enfield","LADU","Level 3","1152","46","197","97","54","1546"
201920,"Enfield","LADU","Level 2","81","11","47","32","27","198"
201920,"Enfield","LADU","All other qualifications","48","11","47","49","39","194"
202021,"Enfield","LADU","Total","1551","45","217","263","125","2201"
202021,"Enfield","LADU","Level 3","1386","29","151","154","70","1790"
202021,"Enfield","LADU","Level 2","102","6","30","46","27","211"
202021,"Enfield","LADU","All other qualifications","63","10","36","63","28","200"
201718,"Greenwich","LADU","Total","917","104","246","240","137","1644"
201718,"Greenwich","LADU","Level 3","803","61","164","108","63","1199"
201718,"Greenwich","LADU","Level 2","62","22","45","46","22","197"
201718,"Greenwich","LADU","All other qualifications","52","21","37","86","52","248"
201819,"Greenwich","LADU","Total","881","90","324","243","115","1653"
201819,"Greenwich","LADU","Level 3","773","47","200","114","61","1195"
201819,"Greenwich","LADU","Level 2","68","27","75","54","17","241"
201819,"Greenwich","LADU","All other qualifications","40","16","49","75","37","217"
201920,"Greenwich","LADU","Total","1073","69","331","262","120","1855"
201920,"Greenwich","LADU","Level 3","891","25","215","112","70","1313"
201920,"Greenwich","LADU","Level 2","97","30","59","58","18","262"
201920,"Greenwich","LADU","All other qualifications","85","14","57","92","32","280"
202021,"Greenwich","LADU","Total","988","58","208","236","86","1576"
202021,"Greenwich","LADU","Level 3","748","18","130","119","37","1052"
202021,"Greenwich","LADU","Level 2","152","14","42","45","14","267"
202021,"Greenwich","LADU","All other qualifications","88","26","36","72","35","257"
201718,"Hackney","LADU","Total","1147","89","384","306","258","2184"
201718,"Hackney","LADU","Level 3","979","45","275","149","103","1551"
201718,"Hackney","LADU","Level 2","89","23","47","55","30","244"
201718,"Hackney","LADU","All other qualifications","79","21","62","102","125","389"
201819,"Hackney","LADU","Total","917","64","280","254","283","1798"
201819,"Hackney","LADU","Level 3","834","38","205","119","75","1271"
201819,"Hackney","LADU","Level 2","62","9","45","51","29","196"
201819,"Hackney","LADU","All other qualifications","21","17","30","84","179","331"
201920,"Hackney","LADU","Total","919","43","217","203","139","1521"
201920,"Hackney","LADU","Level 3","877","26","176","120","56","1255"
201920,"Hackney","LADU","Level 2","28","12","19","27","20","106"
201920,"Hackney","LADU","All other qualifications","14","5","22","56","63","160"
202021,"Hackney","LADU","Total","1067","29","133","212","95","1536"
202021,"Hackney","LADU","Level 3","937","19","105","147","71","1279"
202021,"Hackney","LADU","Level 2","89","3","12","24","9","137"
202021,"Hackney","LADU","All other qualifications","41","7","16","41","15","120"
201718,"Hammersmith and Fulham","LADU","Total","1042","59","252","251","174","1778"
201718,"Hammersmith and Fulham","LADU","Level 3","809","26","147","93","62","1137"
201718,"Hammersmith and Fulham","LADU","Level 2","92","21","42","53","35","243"
201718,"Hammersmith and Fulham","LADU","All other qualifications","141","12","63","105","77","398"
201819,"Hammersmith and Fulham","LADU","Total","1129","49","305","296","161","1940"
201819,"Hammersmith and Fulham","LADU","Level 3","838","26","168","113","69","1214"
201819,"Hammersmith and Fulham","LADU","Level 2","167","12","57","79","26","341"
201819,"Hammersmith and Fulham","LADU","All other qualifications","124","11","80","104","66","385"
201920,"Hammersmith and Fulham","LADU","Total","1038","45","261","319","149","1812"
201920,"Hammersmith and Fulham","LADU","Level 3","804","11","132","116","56","1119"
201920,"Hammersmith and Fulham","LADU","Level 2","98","19","60","66","26","269"
201920,"Hammersmith and Fulham","LADU","All other qualifications","136","15","69","137","67","424"
202021,"Hammersmith and Fulham","LADU","Total","1210","37","170","313","148","1878"
202021,"Hammersmith and Fulham","LADU","Level 3","853","10","72","110","51","1096"
202021,"Hammersmith and Fulham","LADU","Level 2","202","12","40","66","31","351"
202021,"Hammersmith and Fulham","LADU","All other qualifications","155","15","58","137","66","431"
201718,"Haringey","LADU","Total","1026","76","351","316","242","2011"
201718,"Haringey","LADU","Level 3","735","23","178","91","70","1097"
201718,"Haringey","LADU","Level 2","114","31","85","95","38","363"
201718,"Haringey","LADU","All other qualifications","177","22","88","130","134","551"
201819,"Haringey","LADU","Total","1095","81","343","363","215","2097"
201819,"Haringey","LADU","Level 3","830","26","179","118","60","1213"
201819,"Haringey","LADU","Level 2","158","41","65","105","44","413"
201819,"Haringey","LADU","All other qualifications","107","14","99","140","111","471"
201920,"Haringey","LADU","Total","923","61","308","278","146","1716"
201920,"Haringey","LADU","Level 3","795","36","193","125","63","1212"
201920,"Haringey","LADU","Level 2","69","16","51","54","25","215"
201920,"Haringey","LADU","All other qualifications","59","9","64","99","58","289"
202021,"Haringey","LADU","Total","1197","45","164","251","157","1814"
202021,"Haringey","LADU","Level 3","1027","27","105","139","81","1379"
202021,"Haringey","LADU","Level 2","106","8","29","36","17","196"
202021,"Haringey","LADU","All other qualifications","64","10","30","76","59","239"
201718,"Harrow","LADU","Total","1946","70","353","314","199","2882"
201718,"Harrow","LADU","Level 3","1699","41","227","124","83","2174"
201718,"Harrow","LADU","Level 2","155","11","40","52","25","283"
201718,"Harrow","LADU","All other qualifications","92","18","86","138","91","425"
201819,"Harrow","LADU","Total","1417","43","295","205","153","2113"
201819,"Harrow","LADU","Level 3","1310","26","200","101","77","1714"
201819,"Harrow","LADU","Level 2","88","8","52","39","23","210"
201819,"Harrow","LADU","All other qualifications","19","9","43","65","53","189"
201920,"Harrow","LADU","Total","1496","50","238","207","146","2137"
201920,"Harrow","LADU","Level 3","1419","38","184","109","81","1831"
201920,"Harrow","LADU","Level 2","55","7","27","40","23","152"
201920,"Harrow","LADU","All other qualifications","22","5","27","58","42","154"
202021,"Harrow","LADU","Total","1779","40","200","218","130","2367"
202021,"Harrow","LADU","Level 3","1601","25","143","135","83","1987"
202021,"Harrow","LADU","Level 2","131","9","25","39","16","220"
202021,"Harrow","LADU","All other qualifications","47","6","32","44","31","160"
201718,"Havering","LADU","Total","1403","391","782","413","158","3147"
201718,"Havering","LADU","Level 3","1264","240","518","188","65","2275"
201718,"Havering","LADU","Level 2","85","78","174","97","30","464"
201718,"Havering","LADU","All other qualifications","54","73","90","128","63","408"
201819,"Havering","LADU","Total","1469","331","714","373","165","3052"
201819,"Havering","LADU","Level 3","1151","178","410","146","64","1949"
201819,"Havering","LADU","Level 2","234","88","203","121","42","688"
201819,"Havering","LADU","All other qualifications","84","65","101","106","59","415"
201920,"Havering","LADU","Total","1388","316","744","370","169","2987"
201920,"Havering","LADU","Level 3","1198","161","498","170","81","2108"
201920,"Havering","LADU","Level 2","125","83","126","84","31","449"
201920,"Havering","LADU","All other qualifications","65","72","120","116","57","430"
202021,"Havering","LADU","Total","516","159","246","175","92","1188"
202021,"Havering","LADU","Level 3","492","60","132","69","26","779"
202021,"Havering","LADU","Level 2","16","39","44","31","14","144"
202021,"Havering","LADU","All other qualifications","8","60","70","75","52","265"
201718,"Hillingdon","LADU","Total","1879","268","688","359","240","3434"
201718,"Hillingdon","LADU","Level 3","1617","141","481","189","138","2566"
201718,"Hillingdon","LADU","Level 2","161","79","115","73","32","460"
201718,"Hillingdon","LADU","All other qualifications","101","48","92","97","70","408"
201819,"Hillingdon","LADU","Total","2414","267","815","553","284","4333"
201819,"Hillingdon","LADU","Level 3","1843","142","500","243","128","2856"
201819,"Hillingdon","LADU","Level 2","355","82","212","166","69","884"
201819,"Hillingdon","LADU","All other qualifications","216","43","103","144","87","593"
201920,"Hillingdon","LADU","Total","2684","246","817","587","257","4591"
201920,"Hillingdon","LADU","Level 3","2010","136","518","262","115","3041"
201920,"Hillingdon","LADU","Level 2","436","67","179","152","52","886"
201920,"Hillingdon","LADU","All other qualifications","238","43","120","173","90","664"
202021,"Hillingdon","LADU","Total","2699","153","619","652","240","4363"
202021,"Hillingdon","LADU","Level 3","1884","76","343","278","116","2697"
202021,"Hillingdon","LADU","Level 2","513","37","140","167","44","901"
202021,"Hillingdon","LADU","All other qualifications","302","40","136","207","80","765"
201718,"Hounslow","LADU","Total","1384","97","407","294","171","2353"
201718,"Hounslow","LADU","Level 3","1190","65","273","144","91","1763"
201718,"Hounslow","LADU","Level 2","119","19","84","55","33","310"
201718,"Hounslow","LADU","All other qualifications","75","13","50","95","47","280"
201819,"Hounslow","LADU","Total","1431","92","417","309","163","2412"
201819,"Hounslow","LADU","Level 3","1156","56","260","132","78","1682"
201819,"Hounslow","LADU","Level 2","184","19","95","67","29","394"
201819,"Hounslow","LADU","All other qualifications","91","17","62","110","56","336"
201920,"Hounslow","LADU","Total","1530","82","390","319","146","2467"
201920,"Hounslow","LADU","Level 3","1333","48","257","157","75","1870"
201920,"Hounslow","LADU","Level 2","79","18","64","59","26","246"
201920,"Hounslow","LADU","All other qualifications","118","16","69","103","45","351"
202021,"Hounslow","LADU","Total","1660","27","281","356","160","2484"
202021,"Hounslow","LADU","Level 3","1390","16","172","197","88","1863"
202021,"Hounslow","LADU","Level 2","138","5","49","59","19","270"
202021,"Hounslow","LADU","All other qualifications","132","6","60","100","53","351"
201718,"Islington","LADU","Total","339","53","110","123","105","730"
201718,"Islington","LADU","Level 3","330","24","58","49","28","489"
201718,"Islington","LADU","Level 2","5","8","23","21","17","74"
201718,"Islington","LADU","All other qualifications","4","21","29","53","60","167"
201819,"Islington","LADU","Total","338","43","97","95","81","654"
201819,"Islington","LADU","Level 3","335","22","77","57","39","530"
201819,"Islington","LADU","Level 2","3","10","8","16","11","48"
201819,"Islington","LADU","All other qualifications","0","11","12","22","31","76"
201920,"Islington","LADU","Total","333","11","58","43","36","481"
201920,"Islington","LADU","Level 3","317","8","53","36","32","446"
201920,"Islington","LADU","Level 2","3","1","0","2","1","7"
201920,"Islington","LADU","All other qualifications","13","2","5","5","3","28"
202021,"Islington","LADU","Total","302","8","31","50","36","427"
202021,"Islington","LADU","Level 3","290","7","28","41","30","396"
202021,"Islington","LADU","Level 2","3","1","1","1","4","10"
202021,"Islington","LADU","All other qualifications","9","0","2","8","2","21"
201718,"Kensington and Chelsea","LADU","Total","673","23","135","117","112","1060"
201718,"Kensington and Chelsea","LADU","Level 3","609","12","89","67","38","815"
201718,"Kensington and Chelsea","LADU","Level 2","52","5","17","17","9","100"
201718,"Kensington and Chelsea","LADU","All other qualifications","12","6","29","33","65","145"
201819,"Kensington and Chelsea","LADU","Total","636","25","142","116","115","1034"
201819,"Kensington and Chelsea","LADU","Level 3","581","16","89","63","41","790"
201819,"Kensington and Chelsea","LADU","Level 2","37","4","19","22","14","96"
201819,"Kensington and Chelsea","LADU","All other qualifications","18","5","34","31","60","148"
201920,"Kensington and Chelsea","LADU","Total","748","16","198","176","112","1250"
201920,"Kensington and Chelsea","LADU","Level 3","671","11","142","96","42","962"
201920,"Kensington and Chelsea","LADU","Level 2","47","2","14","27","10","100"
201920,"Kensington and Chelsea","LADU","All other qualifications","30","3","42","53","60","188"
202021,"Kensington and Chelsea","LADU","Total","821","16","119","167","103","1226"
202021,"Kensington and Chelsea","LADU","Level 3","687","11","75","101","46","920"
202021,"Kensington and Chelsea","LADU","Level 2","116","4","18","29","8","175"
202021,"Kensington and Chelsea","LADU","All other qualifications","18","1","26","37","49","131"
201718,"Kingston upon Thames","LADU","Total","1302","140","476","224","145","2287"
201718,"Kingston upon Thames","LADU","Level 3","1155","73","330","129","86","1773"
201718,"Kingston upon Thames","LADU","Level 2","93","34","88","35","34","284"
201718,"Kingston upon Thames","LADU","All other qualifications","54","33","58","60","25","230"
201819,"Kingston upon Thames","LADU","Total","1805","150","681","402","239","3277"
201819,"Kingston upon Thames","LADU","Level 3","1272","54","390","162","79","1957"
201819,"Kingston upon Thames","LADU","Level 2","338","70","180","121","89","798"
201819,"Kingston upon Thames","LADU","All other qualifications","195","26","111","119","71","522"
201920,"Kingston upon Thames","LADU","Total","1823","151","673","428","289","3364"
201920,"Kingston upon Thames","LADU","Level 3","1424","74","418","189","103","2208"
201920,"Kingston upon Thames","LADU","Level 2","245","51","146","111","91","644"
201920,"Kingston upon Thames","LADU","All other qualifications","154","26","109","128","95","512"
202021,"Kingston upon Thames","LADU","Total","1952","128","598","592","258","3528"
202021,"Kingston upon Thames","LADU","Level 3","1480","51","325","240","93","2189"
202021,"Kingston upon Thames","LADU","Level 2","297","38","141","155","70","701"
202021,"Kingston upon Thames","LADU","All other qualifications","175","39","132","197","95","638"
201718,"Lambeth","LADU","Total","924","69","252","247","160","1652"
201718,"Lambeth","LADU","Level 3","722","38","137","86","62","1045"
201718,"Lambeth","LADU","Level 2","99","8","44","46","24","221"
201718,"Lambeth","LADU","All other qualifications","103","23","71","115","74","386"
201819,"Lambeth","LADU","Total","925","43","245","201","143","1557"
201819,"Lambeth","LADU","Level 3","717","21","127","77","51","993"
201819,"Lambeth","LADU","Level 2","102","8","43","49","20","222"
201819,"Lambeth","LADU","All other qualifications","106","14","75","75","72","342"
201920,"Lambeth","LADU","Total","793","44","264","256","139","1496"
201920,"Lambeth","LADU","Level 3","629","30","182","100","51","992"
201920,"Lambeth","LADU","Level 2","60","7","22","40","15","144"
201920,"Lambeth","LADU","All other qualifications","104","7","60","116","73","360"
202021,"Lambeth","LADU","Total","948","33","182","297","113","1573"
202021,"Lambeth","LADU","Level 3","721","21","97","127","49","1015"
202021,"Lambeth","LADU","Level 2","76","5","25","38","16","160"
202021,"Lambeth","LADU","All other qualifications","151","7","60","132","48","398"
201718,"Lewisham","LADU","Total","1659","119","458","360","242","2838"
201718,"Lewisham","LADU","Level 3","1293","65","319","179","103","1959"
201718,"Lewisham","LADU","Level 2","243","26","66","71","44","450"
201718,"Lewisham","LADU","All other qualifications","123","28","73","110","95","429"
201819,"Lewisham","LADU","Total","1115","82","318","233","122","1870"
201819,"Lewisham","LADU","Level 3","1060","45","238","128","57","1528"
201819,"Lewisham","LADU","Level 2","41","18","40","45","17","161"
201819,"Lewisham","LADU","All other qualifications","14","19","40","60","48","181"
201920,"Lewisham","LADU","Total","1249","58","298","216","132","1953"
201920,"Lewisham","LADU","Level 3","1161","31","222","111","71","1596"
201920,"Lewisham","LADU","Level 2","62","11","39","41","18","171"
201920,"Lewisham","LADU","All other qualifications","26","16","37","64","43","186"
202021,"Lewisham","LADU","Total","1260","38","137","170","95","1700"
202021,"Lewisham","LADU","Level 3","1043","18","109","113","64","1347"
202021,"Lewisham","LADU","Level 2","203","9","8","30","14","264"
202021,"Lewisham","LADU","All other qualifications","14","11","20","27","17","89"
201718,"Merton","LADU","Total","447","26","103","52","33","661"
201718,"Merton","LADU","Level 3","443","23","96","43","30","635"
201718,"Merton","LADU","Level 2","4","1","3","3","3","14"
201718,"Merton","LADU","All other qualifications","0","2","4","6","0","12"
201819,"Merton","LADU","Total","462","20","96","35","32","645"
201819,"Merton","LADU","Level 3","459","19","91","30","26","625"
201819,"Merton","LADU","Level 2","2","0","2","3","1","8"
201819,"Merton","LADU","All other qualifications","1","1","3","2","5","12"
201920,"Merton","LADU","Total","507","25","98","47","33","710"
201920,"Merton","LADU","Level 3","504","18","94","40","28","684"
201920,"Merton","LADU","Level 2","1","1","1","4","3","10"
201920,"Merton","LADU","All other qualifications","2","6","3","3","2","16"
202021,"Merton","LADU","Total","509","12","61","57","31","670"
202021,"Merton","LADU","Level 3","505","8","52","50","26","641"
202021,"Merton","LADU","Level 2","2","0","3","4","1","10"
202021,"Merton","LADU","All other qualifications","2","4","6","3","4","19"
201718,"Newham","LADU","Total","1573","101","345","377","237","2633"
201718,"Newham","LADU","Level 3","1354","54","209","175","94","1886"
201718,"Newham","LADU","Level 2","65","25","33","55","30","208"
201718,"Newham","LADU","All other qualifications","154","22","103","147","113","539"
201819,"Newham","LADU","Total","2051","122","447","439","275","3334"
201819,"Newham","LADU","Level 3","1569","71","207","169","104","2120"
201819,"Newham","LADU","Level 2","270","21","117","117","48","573"
201819,"Newham","LADU","All other qualifications","212","30","123","153","123","641"
201920,"Newham","LADU","Total","2169","119","460","439","223","3410"
201920,"Newham","LADU","Level 3","1870","73","275","182","91","2491"
201920,"Newham","LADU","Level 2","103","17","74","81","34","309"
201920,"Newham","LADU","All other qualifications","196","29","111","176","98","610"
202021,"Newham","LADU","Total","2678","80","336","586","248","3928"
202021,"Newham","LADU","Level 3","2020","51","191","337","125","2724"
202021,"Newham","LADU","Level 2","450","16","51","92","36","645"
202021,"Newham","LADU","All other qualifications","208","13","94","157","87","559"
201718,"Redbridge","LADU","Total","2069","140","328","298","168","3003"
201718,"Redbridge","LADU","Level 3","1902","105","258","195","102","2562"
201718,"Redbridge","LADU","Level 2","91","17","38","43","24","213"
201718,"Redbridge","LADU","All other qualifications","76","18","32","60","42","228"
201819,"Redbridge","LADU","Total","1889","93","271","209","153","2615"
201819,"Redbridge","LADU","Level 3","1836","72","242","140","116","2406"
201819,"Redbridge","LADU","Level 2","44","9","11","23","8","95"
201819,"Redbridge","LADU","All other qualifications","9","12","18","46","29","114"
201920,"Redbridge","LADU","Total","1917","73","279","208","139","2616"
201920,"Redbridge","LADU","Level 3","1887","57","259","160","116","2479"
201920,"Redbridge","LADU","Level 2","12","4","8","17","11","52"
201920,"Redbridge","LADU","All other qualifications","18","12","12","31","12","85"
202021,"Redbridge","LADU","Total","2171","64","139","240","124","2738"
202021,"Redbridge","LADU","Level 3","2097","54","128","204","105","2588"
202021,"Redbridge","LADU","Level 2","49","1","4","17","6","77"
202021,"Redbridge","LADU","All other qualifications","25","9","7","19","13","73"
201718,"Richmond upon Thames","LADU","Total","856","102","328","181","115","1582"
201718,"Richmond upon Thames","LADU","Level 3","768","61","239","107","64","1239"
201718,"Richmond upon Thames","LADU","Level 2","52","9","36","34","11","142"
201718,"Richmond upon Thames","LADU","All other qualifications","36","32","53","40","40","201"
201819,"Richmond upon Thames","LADU","Total","665","72","286","184","88","1295"
201819,"Richmond upon Thames","LADU","Level 3","544","32","184","89","50","899"
201819,"Richmond upon Thames","LADU","Level 2","102","19","46","32","15","214"
201819,"Richmond upon Thames","LADU","All other qualifications","19","21","56","63","23","182"
201920,"Richmond upon Thames","LADU","Total","694","51","274","187","72","1278"
201920,"Richmond upon Thames","LADU","Level 3","616","28","188","90","43","965"
201920,"Richmond upon Thames","LADU","Level 2","44","11","42","35","4","136"
201920,"Richmond upon Thames","LADU","All other qualifications","34","12","44","62","25","177"
202021,"Richmond upon Thames","LADU","Total","816","55","229","203","88","1391"
202021,"Richmond upon Thames","LADU","Level 3","699","18","137","99","48","1001"
202021,"Richmond upon Thames","LADU","Level 2","84","12","39","34","18","187"
202021,"Richmond upon Thames","LADU","All other qualifications","33","25","53","70","22","203"
201718,"Southwark","LADU","Total","700","48","122","101","59","1030"
201718,"Southwark","LADU","Level 3","696","42","113","89","53","993"
201718,"Southwark","LADU","Level 2","3","2","6","6","4","21"
201718,"Southwark","LADU","All other qualifications","1","4","3","6","2","16"
201819,"Southwark","LADU","Total","718","40","135","84","52","1029"
201819,"Southwark","LADU","Level 3","697","33","118","79","42","969"
201819,"Southwark","LADU","Level 2","21","2","9","3","7","42"
201819,"Southwark","LADU","All other qualifications","0","5","8","2","3","18"
201920,"Southwark","LADU","Total","735","36","153","106","55","1085"
201920,"Southwark","LADU","Level 3","721","30","144","89","49","1033"
201920,"Southwark","LADU","Level 2","3","1","0","4","1","9"
201920,"Southwark","LADU","All other qualifications","11","5","9","13","5","43"
202021,"Southwark","LADU","Total","853","25","112","116","57","1163"
202021,"Southwark","LADU","Level 3","834","20","100","100","50","1104"
202021,"Southwark","LADU","Level 2","3","1","3","3","2","12"
202021,"Southwark","LADU","All other qualifications","16","4","9","13","5","47"
201718,"Sutton","LADU","Total","1466","150","367","198","129","2310"
201718,"Sutton","LADU","Level 3","1320","73","257","96","75","1821"
201718,"Sutton","LADU","Level 2","84","36","52","27","16","215"
201718,"Sutton","LADU","All other qualifications","62","41","58","75","38","274"
201819,"Sutton","LADU","Total","1286","123","334","149","102","1994"
201819,"Sutton","LADU","Level 3","1255","74","282","101","67","1779"
201819,"Sutton","LADU","Level 2","21","12","23","15","8","79"
201819,"Sutton","LADU","All other qualifications","10","37","29","33","27","136"
201920,"Sutton","LADU","Total","1316","92","302","127","103","1940"
201920,"Sutton","LADU","Level 3","1272","61","265","92","72","1762"
201920,"Sutton","LADU","Level 2","6","11","10","7","11","45"
201920,"Sutton","LADU","All other qualifications","38","20","27","28","20","133"
202021,"Sutton","LADU","Total","1357","55","263","150","90","1915"
202021,"Sutton","LADU","Level 3","1322","40","242","137","81","1822"
202021,"Sutton","LADU","Level 2","8","5","7","6","3","29"
202021,"Sutton","LADU","All other qualifications","27","10","14","7","6","64"
201718,"Tower Hamlets","LADU","Total","1310","103","222","200","125","1960"
201718,"Tower Hamlets","LADU","Level 3","1127","70","163","120","61","1541"
201718,"Tower Hamlets","LADU","Level 2","90","15","25","27","25","182"
201718,"Tower Hamlets","LADU","All other qualifications","93","18","34","53","39","237"
201819,"Tower Hamlets","LADU","Total","1579","92","405","344","173","2593"
201819,"Tower Hamlets","LADU","Level 3","1241","57","260","148","71","1777"
201819,"Tower Hamlets","LADU","Level 2","186","19","64","88","27","384"
201819,"Tower Hamlets","LADU","All other qualifications","152","16","81","108","75","432"
201920,"Tower Hamlets","LADU","Total","1799","101","552","520","257","3229"
201920,"Tower Hamlets","LADU","Level 3","1504","66","397","257","112","2336"
201920,"Tower Hamlets","LADU","Level 2","179","19","71","109","38","416"
201920,"Tower Hamlets","LADU","All other qualifications","116","16","84","154","107","477"
202021,"Tower Hamlets","LADU","Total","3644","174","886","1050","336","6090"
202021,"Tower Hamlets","LADU","Level 3","2540","87","545","504","163","3839"
202021,"Tower Hamlets","LADU","Level 2","632","39","161","218","51","1101"
202021,"Tower Hamlets","LADU","All other qualifications","472","48","180","328","122","1150"
201718,"Waltham Forest","LADU","Total","2072","170","551","423","267","3483"
201718,"Waltham Forest","LADU","Level 3","1853","111","414","243","142","2763"
201718,"Waltham Forest","LADU","Level 2","141","26","58","70","44","339"
201718,"Waltham Forest","LADU","All other qualifications","78","33","79","110","81","381"
201819,"Waltham Forest","LADU","Total","2044","172","477","413","227","3333"
201819,"Waltham Forest","LADU","Level 3","1560","117","315","177","107","2276"
201819,"Waltham Forest","LADU","Level 2","425","31","104","122","51","733"
201819,"Waltham Forest","LADU","All other qualifications","59","24","58","114","69","324"
201920,"Waltham Forest","LADU","Total","2054","128","474","448","190","3294"
201920,"Waltham Forest","LADU","Level 3","1854","76","340","226","90","2586"
201920,"Waltham Forest","LADU","Level 2","108","23","56","76","22","285"
201920,"Waltham Forest","LADU","All other qualifications","92","29","78","146","78","423"
202021,"Waltham Forest","LADU","Total","2238","83","368","567","215","3471"
202021,"Waltham Forest","LADU","Level 3","1683","43","254","317","113","2410"
202021,"Waltham Forest","LADU","Level 2","422","15","49","92","32","610"
202021,"Waltham Forest","LADU","All other qualifications","133","25","65","158","70","451"
201718,"Wandsworth","LADU","Total","1761","93","529","436","275","3094"
201718,"Wandsworth","LADU","Level 3","1481","50","333","203","107","2174"
201718,"Wandsworth","LADU","Level 2","173","23","112","93","81","482"
201718,"Wandsworth","LADU","All other qualifications","107","20","84","140","87","438"
201819,"Wandsworth","LADU","Total","1354","76","382","292","179","2283"
201819,"Wandsworth","LADU","Level 3","1224","42","277","134","87","1764"
201819,"Wandsworth","LADU","Level 2","110","10","59","59","26","264"
201819,"Wandsworth","LADU","All other qualifications","20","24","46","99","66","255"
201920,"Wandsworth","LADU","Total","1344","60","322","276","141","2143"
201920,"Wandsworth","LADU","Level 3","1244","35","246","152","85","1762"
201920,"Wandsworth","LADU","Level 2","55","5","37","47","15","159"
201920,"Wandsworth","LADU","All other qualifications","45","20","39","77","41","222"
202021,"Wandsworth","LADU","Total","1415","30","228","226","143","2042"
202021,"Wandsworth","LADU","Level 3","1265","16","181","153","106","1721"
202021,"Wandsworth","LADU","Level 2","106","8","27","35","15","191"
202021,"Wandsworth","LADU","All other qualifications","44","6","20","38","22","130"
201718,"Westminster","LADU","Total","1457","91","314","319","209","2390"
201718,"Westminster","LADU","Level 3","1332","50","197","152","96","1827"
201718,"Westminster","LADU","Level 2","83","18","45","55","31","232"
201718,"Westminster","LADU","All other qualifications","42","23","72","112","82","331"
201819,"Westminster","LADU","Total","1974","108","491","389","251","3213"
201819,"Westminster","LADU","Level 3","1285","49","260","143","82","1819"
201819,"Westminster","LADU","Level 2","443","34","106","96","52","731"
201819,"Westminster","LADU","All other qualifications","246","25","125","150","117","663"
201920,"Westminster","LADU","Total","1756","66","433","413","210","2878"
201920,"Westminster","LADU","Level 3","1491","34","237","139","93","1994"
201920,"Westminster","LADU","Level 2","122","21","74","87","29","333"
201920,"Westminster","LADU","All other qualifications","143","11","122","187","88","551"
202021,"Westminster","LADU","Total","2107","94","373","540","270","3384"
202021,"Westminster","LADU","Level 3","1655","37","179","252","123","2246"
202021,"Westminster","LADU","Level 2","244","24","71","89","40","468"
202021,"Westminster","LADU","All other qualifications","208","33","123","199","107","670"
201718,"Adur","LADU","Total","60","13","52","19","10","154"
201718,"Adur","LADU","Level 3","57","8","41","12","7","125"
201718,"Adur","LADU","Level 2","3","4","7","5","2","21"
201718,"Adur","LADU","All other qualifications","0","1","4","2","1","8"
201819,"Adur","LADU","Total","70","9","61","24","24","188"
201819,"Adur","LADU","Level 3","65","5","56","12","16","154"
201819,"Adur","LADU","Level 2","5","3","4","7","7","26"
201819,"Adur","LADU","All other qualifications","0","1","1","5","1","8"
201920,"Adur","LADU","Total","46","9","56","17","16","144"
201920,"Adur","LADU","Level 3","40","5","41","9","12","107"
201920,"Adur","LADU","Level 2","6","3","10","6","4","29"
201920,"Adur","LADU","All other qualifications","0","1","5","2","0","8"
202021,"Adur","LADU","Total","100","9","57","33","28","227"
202021,"Adur","LADU","Level 3","94","7","50","21","17","189"
202021,"Adur","LADU","Level 2","5","2","3","6","10","26"
202021,"Adur","LADU","All other qualifications","1","0","4","6","1","12"
201718,"Arun","LADU","Total","213","28","133","28","18","420"
201718,"Arun","LADU","Level 3","203","24","117","15","12","371"
201718,"Arun","LADU","Level 2","7","2","12","9","2","32"
201718,"Arun","LADU","All other qualifications","3","2","4","4","4","17"
201819,"Arun","LADU","Total","211","25","122","30","13","401"
201819,"Arun","LADU","Level 3","198","19","100","21","7","345"
201819,"Arun","LADU","Level 2","12","4","13","5","4","38"
201819,"Arun","LADU","All other qualifications","1","2","9","4","2","18"
201920,"Arun","LADU","Total","244","12","119","23","15","413"
201920,"Arun","LADU","Level 3","236","9","100","15","10","370"
201920,"Arun","LADU","Level 2","2","0","11","4","4","21"
201920,"Arun","LADU","All other qualifications","6","3","8","4","1","22"
202021,"Arun","LADU","Total","219","16","105","43","16","399"
202021,"Arun","LADU","Level 3","202","12","86","29","11","340"
202021,"Arun","LADU","Level 2","10","2","7","7","2","28"
202021,"Arun","LADU","All other qualifications","7","2","12","7","3","31"
201718,"Ashford","LADU","Total","412","46","259","69","42","828"
201718,"Ashford","LADU","Level 3","403","34","221","54","36","748"
201718,"Ashford","LADU","Level 2","8","5","24","9","3","49"
201718,"Ashford","LADU","All other qualifications","1","7","14","6","3","31"
201819,"Ashford","LADU","Total","412","58","260","73","48","851"
201819,"Ashford","LADU","Level 3","396","43","220","47","39","745"
201819,"Ashford","LADU","Level 2","15","12","29","18","6","80"
201819,"Ashford","LADU","All other qualifications","1","3","11","8","3","26"
201920,"Ashford","LADU","Total","399","34","214","74","37","758"
201920,"Ashford","LADU","Level 3","392","19","185","53","31","680"
201920,"Ashford","LADU","Level 2","6","6","19","11","3","45"
201920,"Ashford","LADU","All other qualifications","1","9","10","10","3","33"
202021,"Ashford","LADU","Total","407","45","208","93","47","800"
202021,"Ashford","LADU","Level 3","391","26","184","69","31","701"
202021,"Ashford","LADU","Level 2","12","10","13","18","8","61"
202021,"Ashford","LADU","All other qualifications","4","9","11","6","8","38"
201718,"Aylesbury Vale","LADU","Total","936","168","584","188","87","1963"
201718,"Aylesbury Vale","LADU","Level 3","905","79","410","117","49","1560"
201718,"Aylesbury Vale","LADU","Level 2","17","42","89","22","9","179"
201718,"Aylesbury Vale","LADU","All other qualifications","14","47","85","49","29","224"
201819,"Aylesbury Vale","LADU","Total","985","151","535","226","91","1988"
201819,"Aylesbury Vale","LADU","Level 3","858","64","304","98","47","1371"
201819,"Aylesbury Vale","LADU","Level 2","93","52","150","59","17","371"
201819,"Aylesbury Vale","LADU","All other qualifications","34","35","81","69","27","246"
201920,"Aylesbury Vale","LADU","Total","1078","156","663","225","105","2227"
201920,"Aylesbury Vale","LADU","Level 3","975","73","466","121","53","1688"
201920,"Aylesbury Vale","LADU","Level 2","58","52","99","26","11","246"
201920,"Aylesbury Vale","LADU","All other qualifications","45","31","98","78","41","293"
202021,"Aylesbury Vale","LADU","Total","1225","153","627","352","146","2503"
202021,"Aylesbury Vale","LADU","Level 3","1038","61","398","153","68","1718"
202021,"Aylesbury Vale","LADU","Level 2","110","53","118","83","30","394"
202021,"Aylesbury Vale","LADU","All other qualifications","77","39","111","116","48","391"
201718,"Basingstoke and Deane","LADU","Total","632","184","747","229","73","1865"
201718,"Basingstoke and Deane","LADU","Level 3","569","88","486","93","29","1265"
201718,"Basingstoke and Deane","LADU","Level 2","49","52","183","72","28","384"
201718,"Basingstoke and Deane","LADU","All other qualifications","14","44","78","64","16","216"
201819,"Basingstoke and Deane","LADU","Total","572","201","789","210","79","1851"
201819,"Basingstoke and Deane","LADU","Level 3","468","94","399","70","25","1056"
201819,"Basingstoke and Deane","LADU","Level 2","84","74","298","88","25","569"
201819,"Basingstoke and Deane","LADU","All other qualifications","20","33","92","52","29","226"
201920,"Basingstoke and Deane","LADU","Total","618","168","627","175","59","1647"
201920,"Basingstoke and Deane","LADU","Level 3","552","83","413","74","33","1155"
201920,"Basingstoke and Deane","LADU","Level 2","46","53","142","52","13","306"
201920,"Basingstoke and Deane","LADU","All other qualifications","20","32","72","49","13","186"
202021,"Basingstoke and Deane","LADU","Total","746","150","618","244","78","1836"
202021,"Basingstoke and Deane","LADU","Level 3","597","72","387","116","30","1202"
202021,"Basingstoke and Deane","LADU","Level 2","105","46","148","69","20","388"
202021,"Basingstoke and Deane","LADU","All other qualifications","44","32","83","59","28","246"
201718,"Bracknell Forest","LADU","Total","373","148","367","101","53","1042"
201718,"Bracknell Forest","LADU","Level 3","318","68","232","54","16","688"
201718,"Bracknell Forest","LADU","Level 2","43","50","79","20","12","204"
201718,"Bracknell Forest","LADU","All other qualifications","12","30","56","27","25","150"
201819,"Bracknell Forest","LADU","Total","331","116","376","123","63","1009"
201819,"Bracknell Forest","LADU","Level 3","311","52","241","47","26","677"
201819,"Bracknell Forest","LADU","Level 2","15","40","84","38","14","191"
201819,"Bracknell Forest","LADU","All other qualifications","5","24","51","38","23","141"
201920,"Bracknell Forest","LADU","Total","322","97","369","114","48","950"
201920,"Bracknell Forest","LADU","Level 3","285","43","248","40","25","641"
201920,"Bracknell Forest","LADU","Level 2","29","25","76","31","10","171"
201920,"Bracknell Forest","LADU","All other qualifications","8","29","45","43","13","138"
202021,"Bracknell Forest","LADU","Total","279","49","194","69","42","633"
202021,"Bracknell Forest","LADU","Level 3","272","17","119","34","23","465"
202021,"Bracknell Forest","LADU","Level 2","6","15","40","16","6","83"
202021,"Bracknell Forest","LADU","All other qualifications","1","17","35","19","13","85"
201718,"Brighton and Hove","LADU","Total","1411","179","924","466","258","3238"
201718,"Brighton and Hove","LADU","Level 3","1229","79","721","279","153","2461"
201718,"Brighton and Hove","LADU","Level 2","115","63","123","83","52","436"
201718,"Brighton and Hove","LADU","All other qualifications","67","37","80","104","53","341"
201819,"Brighton and Hove","LADU","Total","1234","130","852","335","204","2755"
201819,"Brighton and Hove","LADU","Level 3","1126","69","714","220","135","2264"
201819,"Brighton and Hove","LADU","Level 2","82","33","83","46","26","270"
201819,"Brighton and Hove","LADU","All other qualifications","26","28","55","69","43","221"
201920,"Brighton and Hove","LADU","Total","1249","93","880","372","199","2793"
201920,"Brighton and Hove","LADU","Level 3","1146","42","773","252","149","2362"
201920,"Brighton and Hove","LADU","Level 2","60","24","53","56","21","214"
201920,"Brighton and Hove","LADU","All other qualifications","43","27","54","64","29","217"
202021,"Brighton and Hove","LADU","Total","1543","82","651","385","196","2857"
202021,"Brighton and Hove","LADU","Level 3","1419","38","590","303","166","2516"
202021,"Brighton and Hove","LADU","Level 2","85","13","28","42","13","181"
202021,"Brighton and Hove","LADU","All other qualifications","39","31","33","40","17","160"
201718,"Canterbury","LADU","Total","1211","229","988","599","285","3312"
201718,"Canterbury","LADU","Level 3","916","94","560","203","121","1894"
201718,"Canterbury","LADU","Level 2","207","76","296","191","67","837"
201718,"Canterbury","LADU","All other qualifications","88","59","132","205","97","581"
201819,"Canterbury","LADU","Total","844","141","626","383","176","2170"
201819,"Canterbury","LADU","Level 3","712","45","362","139","81","1339"
201819,"Canterbury","LADU","Level 2","66","43","156","92","33","390"
201819,"Canterbury","LADU","All other qualifications","66","53","108","152","62","441"
201920,"Canterbury","LADU","Total","579","108","583","393","170","1833"
201920,"Canterbury","LADU","Level 3","550","40","357","133","68","1148"
201920,"Canterbury","LADU","Level 2","12","39","130","90","42","313"
201920,"Canterbury","LADU","All other qualifications","17","29","96","170","60","372"
202021,"Canterbury","LADU","Total","681","65","335","277","127","1485"
202021,"Canterbury","LADU","Level 3","644","22","227","106","48","1047"
202021,"Canterbury","LADU","Level 2","16","16","47","51","39","169"
202021,"Canterbury","LADU","All other qualifications","21","27","61","120","40","269"
201718,"Cherwell","LADU","Total","297","38","153","18","15","521"
201718,"Cherwell","LADU","Level 3","296","35","146","15","13","505"
201718,"Cherwell","LADU","Level 2","1","1","4","1","1","8"
201718,"Cherwell","LADU","All other qualifications","0","2","3","2","1","8"
201819,"Cherwell","LADU","Total","275","26","169","32","23","525"
201819,"Cherwell","LADU","Level 3","270","25","160","27","19","501"
201819,"Cherwell","LADU","Level 2","2","1","6","0","2","11"
201819,"Cherwell","LADU","All other qualifications","3","0","3","5","2","13"
201920,"Cherwell","LADU","Total","274","31","174","33","13","525"
201920,"Cherwell","LADU","Level 3","266","26","163","30","11","496"
201920,"Cherwell","LADU","Level 2","2","2","2","0","1","7"
201920,"Cherwell","LADU","All other qualifications","6","3","9","3","1","22"
202021,"Cherwell","LADU","Total","276","15","133","30","11","465"
202021,"Cherwell","LADU","Level 3","274","12","114","26","8","434"
202021,"Cherwell","LADU","Level 2","1","0","7","3","1","12"
202021,"Cherwell","LADU","All other qualifications","1","3","12","1","2","19"
201718,"Chichester","LADU","Total","849","136","708","262","149","2104"
201718,"Chichester","LADU","Level 3","621","54","351","77","53","1156"
201718,"Chichester","LADU","Level 2","141","43","225","78","42","529"
201718,"Chichester","LADU","All other qualifications","87","39","132","107","54","419"
201819,"Chichester","LADU","Total","984","158","801","329","204","2476"
201819,"Chichester","LADU","Level 3","587","52","376","87","52","1154"
201819,"Chichester","LADU","Level 2","245","56","263","102","70","736"
201819,"Chichester","LADU","All other qualifications","152","50","162","140","82","586"
201920,"Chichester","LADU","Total","974","202","801","370","192","2539"
201920,"Chichester","LADU","Level 3","622","49","396","103","55","1225"
201920,"Chichester","LADU","Level 2","188","65","209","108","58","628"
201920,"Chichester","LADU","All other qualifications","164","88","196","159","79","686"
202021,"Chichester","LADU","Total","1424","179","858","469","209","3139"
202021,"Chichester","LADU","Level 3","920","60","481","172","82","1715"
202021,"Chichester","LADU","Level 2","285","54","204","122","43","708"
202021,"Chichester","LADU","All other qualifications","219","65","173","175","84","716"
201718,"Chiltern","LADU","Total","870","82","415","167","85","1619"
201718,"Chiltern","LADU","Level 3","804","29","283","91","46","1253"
201718,"Chiltern","LADU","Level 2","40","26","73","41","15","195"
201718,"Chiltern","LADU","All other qualifications","26","27","59","35","24","171"
201819,"Chiltern","LADU","Total","792","84","411","164","70","1521"
201819,"Chiltern","LADU","Level 3","697","50","300","87","46","1180"
201819,"Chiltern","LADU","Level 2","73","20","54","37","8","192"
201819,"Chiltern","LADU","All other qualifications","22","14","57","40","16","149"
201920,"Chiltern","LADU","Total","612","51","261","101","48","1073"
201920,"Chiltern","LADU","Level 3","606","39","198","50","25","918"
201920,"Chiltern","LADU","Level 2","1","6","26","14","7","54"
201920,"Chiltern","LADU","All other qualifications","5","6","37","37","16","101"
202021,"Chiltern","LADU","Total","592","53","202","87","47","981"
202021,"Chiltern","LADU","Level 3","585","30","168","51","36","870"
202021,"Chiltern","LADU","Level 2","3","7","18","13","6","47"
202021,"Chiltern","LADU","All other qualifications","4","16","16","23","5","64"
201718,"Crawley","LADU","Total","636","178","580","224","114","1732"
201718,"Crawley","LADU","Level 3","530","75","359","84","32","1080"
201718,"Crawley","LADU","Level 2","43","67","121","48","19","298"
201718,"Crawley","LADU","All other qualifications","63","36","100","92","63","354"
201819,"Crawley","LADU","Total","364","114","337","120","35","970"
201819,"Crawley","LADU","Level 3","343","45","201","45","8","642"
201819,"Crawley","LADU","Level 2","18","38","66","29","6","157"
201819,"Crawley","LADU","All other qualifications","3","31","70","46","21","171"
201920,"Crawley","LADU","Total","344","93","240","85","34","796"
201920,"Crawley","LADU","Level 3","339","39","134","35","16","563"
201920,"Crawley","LADU","Level 2","5","24","52","15","5","101"
201920,"Crawley","LADU","All other qualifications","0","30","54","35","13","132"
202021,"Crawley","LADU","Total","317","29","150","54","28","578"
202021,"Crawley","LADU","Level 3","290","19","112","35","19","475"
202021,"Crawley","LADU","Level 2","19","4","30","14","3","70"
202021,"Crawley","LADU","All other qualifications","8","6","8","5","6","33"
201718,"Dartford","LADU","Total","1108","249","754","329","154","2594"
201718,"Dartford","LADU","Level 3","937","135","468","144","61","1745"
201718,"Dartford","LADU","Level 2","123","35","174","80","28","440"
201718,"Dartford","LADU","All other qualifications","48","79","112","105","65","409"
201819,"Dartford","LADU","Total","941","265","609","278","120","2213"
201819,"Dartford","LADU","Level 3","889","140","372","126","49","1576"
201819,"Dartford","LADU","Level 2","37","69","148","68","21","343"
201819,"Dartford","LADU","All other qualifications","15","56","89","84","50","294"
201920,"Dartford","LADU","Total","1059","217","778","340","138","2532"
201920,"Dartford","LADU","Level 3","947","108","517","180","70","1822"
201920,"Dartford","LADU","Level 2","57","36","153","71","24","341"
201920,"Dartford","LADU","All other qualifications","55","73","108","89","44","369"
202021,"Dartford","LADU","Total","1148","167","620","358","121","2414"
202021,"Dartford","LADU","Level 3","1018","66","393","174","66","1717"
202021,"Dartford","LADU","Level 2","76","41","124","94","26","361"
202021,"Dartford","LADU","All other qualifications","54","60","103","90","29","336"
201718,"Dover","LADU","Total","380","37","150","62","34","663"
201718,"Dover","LADU","Level 3","374","33","141","50","25","623"
201718,"Dover","LADU","Level 2","1","3","7","8","5","24"
201718,"Dover","LADU","All other qualifications","5","1","2","4","4","16"
201819,"Dover","LADU","Total","361","44","171","63","44","683"
201819,"Dover","LADU","Level 3","350","34","143","41","33","601"
201819,"Dover","LADU","Level 2","6","6","22","17","9","60"
201819,"Dover","LADU","All other qualifications","5","4","6","5","2","22"
201920,"Dover","LADU","Total","337","24","160","64","39","624"
201920,"Dover","LADU","Level 3","324","19","133","43","35","554"
201920,"Dover","LADU","Level 2","8","2","20","17","1","48"
201920,"Dover","LADU","All other qualifications","5","3","7","4","3","22"
202021,"Dover","LADU","Total","386","22","119","76","33","636"
202021,"Dover","LADU","Level 3","370","13","103","55","27","568"
202021,"Dover","LADU","Level 2","2","6","9","15","3","35"
202021,"Dover","LADU","All other qualifications","14","3","7","6","3","33"
201718,"East Hampshire","LADU","Total","345","50","298","84","36","813"
201718,"East Hampshire","LADU","Level 3","319","36","256","52","21","684"
201718,"East Hampshire","LADU","Level 2","17","4","25","19","7","72"
201718,"East Hampshire","LADU","All other qualifications","9","10","17","13","8","57"
201819,"East Hampshire","LADU","Total","330","43","245","73","33","724"
201819,"East Hampshire","LADU","Level 3","306","30","185","49","18","588"
201819,"East Hampshire","LADU","Level 2","20","8","37","14","8","87"
201819,"East Hampshire","LADU","All other qualifications","4","5","23","10","7","49"
201920,"East Hampshire","LADU","Total","336","33","238","60","33","700"
201920,"East Hampshire","LADU","Level 3","303","23","193","44","27","590"
201920,"East Hampshire","LADU","Level 2","16","4","25","9","3","57"
201920,"East Hampshire","LADU","All other qualifications","17","6","20","7","3","53"
202021,"East Hampshire","LADU","Total","45","10","42","16","13","126"
202021,"East Hampshire","LADU","Level 3","42","2","21","6","5","76"
202021,"East Hampshire","LADU","Level 2","2","1","10","3","3","19"
202021,"East Hampshire","LADU","All other qualifications","1","7","11","7","5","31"
201718,"Eastbourne","LADU","Total","437","156","553","230","129","1505"
201718,"Eastbourne","LADU","Level 3","350","76","363","88","47","924"
201718,"Eastbourne","LADU","Level 2","50","45","105","58","20","278"
201718,"Eastbourne","LADU","All other qualifications","37","35","85","84","62","303"
201819,"Eastbourne","LADU","Total","689","142","705","338","143","2017"
201819,"Eastbourne","LADU","Level 3","494","58","417","126","47","1142"
201819,"Eastbourne","LADU","Level 2","130","47","177","100","36","490"
201819,"Eastbourne","LADU","All other qualifications","65","37","111","112","60","385"
201920,"Eastbourne","LADU","Total","10","44","112","84","54","304"
201920,"Eastbourne","LADU","Level 3","8","4","19","3","10","44"
201920,"Eastbourne","LADU","Level 2","0","15","37","18","6","76"
201920,"Eastbourne","LADU","All other qualifications","2","25","56","63","38","184"
202021,"Eastbourne","LADU","Total","1145","184","831","642","208","3010"
202021,"Eastbourne","LADU","Level 3","754","48","397","196","54","1449"
202021,"Eastbourne","LADU","Level 2","250","79","249","201","53","832"
202021,"Eastbourne","LADU","All other qualifications","141","57","185","245","101","729"
201718,"Eastleigh","LADU","Total","883","251","620","218","90","2062"
201718,"Eastleigh","LADU","Level 3","797","121","459","102","37","1516"
201718,"Eastleigh","LADU","Level 2","41","59","102","39","19","260"
201718,"Eastleigh","LADU","All other qualifications","45","71","59","77","34","286"
201819,"Eastleigh","LADU","Total","953","234","742","198","83","2210"
201819,"Eastleigh","LADU","Level 3","832","124","489","99","40","1584"
201819,"Eastleigh","LADU","Level 2","74","64","168","41","20","367"
201819,"Eastleigh","LADU","All other qualifications","47","46","85","58","23","259"
201920,"Eastleigh","LADU","Total","1077","223","734","224","68","2326"
201920,"Eastleigh","LADU","Level 3","979","122","562","132","36","1831"
201920,"Eastleigh","LADU","Level 2","40","59","82","36","18","235"
201920,"Eastleigh","LADU","All other qualifications","58","42","90","56","14","260"
202021,"Eastleigh","LADU","Total","1170","172","634","287","92","2355"
202021,"Eastleigh","LADU","Level 3","1042","78","471","160","53","1804"
202021,"Eastleigh","LADU","Level 2","48","39","76","37","11","211"
202021,"Eastleigh","LADU","All other qualifications","80","55","87","90","28","340"
201718,"Elmbridge","LADU","Total","869","131","618","253","106","1977"
201718,"Elmbridge","LADU","Level 3","763","65","470","141","62","1501"
201718,"Elmbridge","LADU","Level 2","41","35","60","37","16","189"
201718,"Elmbridge","LADU","All other qualifications","65","31","88","75","28","287"
201819,"Elmbridge","LADU","Total","911","110","618","273","96","2008"
201819,"Elmbridge","LADU","Level 3","747","36","406","117","35","1341"
201819,"Elmbridge","LADU","Level 2","101","39","115","72","17","344"
201819,"Elmbridge","LADU","All other qualifications","63","35","97","84","44","323"
201920,"Elmbridge","LADU","Total","877","104","600","254","112","1947"
201920,"Elmbridge","LADU","Level 3","767","42","425","121","63","1418"
201920,"Elmbridge","LADU","Level 2","54","36","92","55","20","257"
201920,"Elmbridge","LADU","All other qualifications","56","26","83","78","29","272"
202021,"Elmbridge","LADU","Total","940","73","471","266","126","1876"
202021,"Elmbridge","LADU","Level 3","828","19","307","150","64","1368"
202021,"Elmbridge","LADU","Level 2","47","23","70","40","21","201"
202021,"Elmbridge","LADU","All other qualifications","65","31","94","76","41","307"
201718,"Epsom and Ewell","LADU","Total","787","135","371","158","103","1554"
201718,"Epsom and Ewell","LADU","Level 3","649","55","255","65","40","1064"
201718,"Epsom and Ewell","LADU","Level 2","102","55","78","39","29","303"
201718,"Epsom and Ewell","LADU","All other qualifications","36","25","38","54","34","187"
201819,"Epsom and Ewell","LADU","Total","770","143","366","178","104","1561"
201819,"Epsom and Ewell","LADU","Level 3","602","45","213","61","39","960"
201819,"Epsom and Ewell","LADU","Level 2","105","62","101","52","28","348"
201819,"Epsom and Ewell","LADU","All other qualifications","63","36","52","65","37","253"
201920,"Epsom and Ewell","LADU","Total","697","173","369","170","91","1500"
201920,"Epsom and Ewell","LADU","Level 3","543","61","231","69","32","936"
201920,"Epsom and Ewell","LADU","Level 2","97","52","74","42","19","284"
201920,"Epsom and Ewell","LADU","All other qualifications","57","60","64","59","40","280"
202021,"Epsom and Ewell","LADU","Total","697","113","327","195","82","1414"
202021,"Epsom and Ewell","LADU","Level 3","525","30","200","82","40","877"
202021,"Epsom and Ewell","LADU","Level 2","102","41","55","41","19","258"
202021,"Epsom and Ewell","LADU","All other qualifications","70","42","72","72","23","279"
201718,"Fareham","LADU","Total","124","149","307","135","48","763"
201718,"Fareham","LADU","Level 3","85","52","131","26","14","308"
201718,"Fareham","LADU","Level 2","27","58","133","47","15","280"
201718,"Fareham","LADU","All other qualifications","12","39","43","62","19","175"
201819,"Fareham","LADU","Total","194","127","320","161","44","846"
201819,"Fareham","LADU","Level 3","91","25","84","24","9","233"
201819,"Fareham","LADU","Level 2","88","70","174","79","11","422"
201819,"Fareham","LADU","All other qualifications","15","32","62","58","24","191"
201920,"Fareham","LADU","Total","139","113","258","126","39","675"
201920,"Fareham","LADU","Level 3","88","38","107","28","17","278"
201920,"Fareham","LADU","Level 2","43","56","105","46","7","257"
201920,"Fareham","LADU","All other qualifications","8","19","46","52","15","140"
202021,"Fareham","LADU","Total","225","122","275","155","40","817"
202021,"Fareham","LADU","Level 3","133","29","109","28","13","312"
202021,"Fareham","LADU","Level 2","71","71","114","70","14","340"
202021,"Fareham","LADU","All other qualifications","21","22","52","57","13","165"
201718,"Folkestone and Hythe","LADU","Total","276","32","135","61","29","533"
201718,"Folkestone and Hythe","LADU","Level 3","274","24","121","48","23","490"
201718,"Folkestone and Hythe","LADU","Level 2","1","3","9","8","3","24"
201718,"Folkestone and Hythe","LADU","All other qualifications","1","5","5","5","3","19"
201819,"Folkestone and Hythe","LADU","Total","301","33","158","58","37","587"
201819,"Folkestone and Hythe","LADU","Level 3","289","23","133","42","24","511"
201819,"Folkestone and Hythe","LADU","Level 2","10","8","17","10","9","54"
201819,"Folkestone and Hythe","LADU","All other qualifications","2","2","8","6","4","22"
201920,"Folkestone and Hythe","LADU","Total","232","24","107","41","24","428"
201920,"Folkestone and Hythe","LADU","Level 3","232","18","94","30","19","393"
201920,"Folkestone and Hythe","LADU","Level 2","0","3","6","4","3","16"
201920,"Folkestone and Hythe","LADU","All other qualifications","0","3","7","7","2","19"
202021,"Folkestone and Hythe","LADU","Total","284","11","96","57","12","460"
202021,"Folkestone and Hythe","LADU","Level 3","273","8","85","50","8","424"
202021,"Folkestone and Hythe","LADU","Level 2","4","3","3","3","2","15"
202021,"Folkestone and Hythe","LADU","All other qualifications","7","0","8","4","2","21"
201718,"Gosport","LADU","Total","277","37","162","71","21","568"
201718,"Gosport","LADU","Level 3","222","24","127","32","9","414"
201718,"Gosport","LADU","Level 2","8","8","17","12","6","51"
201718,"Gosport","LADU","All other qualifications","47","5","18","27","6","103"
201819,"Gosport","LADU","Total","259","38","157","85","24","563"
201819,"Gosport","LADU","Level 3","225","22","112","28","11","398"
201819,"Gosport","LADU","Level 2","13","12","35","22","9","91"
201819,"Gosport","LADU","All other qualifications","21","4","10","35","4","74"
201920,"Gosport","LADU","Total","307","31","154","78","20","590"
201920,"Gosport","LADU","Level 3","268","17","104","30","9","428"
201920,"Gosport","LADU","Level 2","8","6","19","8","1","42"
201920,"Gosport","LADU","All other qualifications","31","8","31","40","10","120"
202021,"Gosport","LADU","Total","302","10","107","74","23","516"
202021,"Gosport","LADU","Level 3","237","7","72","41","8","365"
202021,"Gosport","LADU","Level 2","31","3","24","18","4","80"
202021,"Gosport","LADU","All other qualifications","34","0","11","15","11","71"
201718,"Gravesham","LADU","Total","368","60","145","57","28","658"
201718,"Gravesham","LADU","Level 3","368","54","136","55","22","635"
201718,"Gravesham","LADU","Level 2","0","2","7","0","0","9"
201718,"Gravesham","LADU","All other qualifications","0","4","2","2","6","14"
201819,"Gravesham","LADU","Total","337","52","148","69","22","628"
201819,"Gravesham","LADU","Level 3","336","49","142","62","18","607"
201819,"Gravesham","LADU","Level 2","1","1","4","4","2","12"
201819,"Gravesham","LADU","All other qualifications","0","2","2","3","2","9"
201920,"Gravesham","LADU","Total","389","49","125","64","29","656"
201920,"Gravesham","LADU","Level 3","378","39","115","53","22","607"
201920,"Gravesham","LADU","Level 2","10","3","4","7","6","30"
201920,"Gravesham","LADU","All other qualifications","1","7","6","4","1","19"
202021,"Gravesham","LADU","Total","449","22","118","72","22","683"
202021,"Gravesham","LADU","Level 3","439","18","94","60","16","627"
202021,"Gravesham","LADU","Level 2","7","2","10","5","2","26"
202021,"Gravesham","LADU","All other qualifications","3","2","14","7","4","30"
201718,"Guildford","LADU","Total","676","122","708","231","164","1901"
201718,"Guildford","LADU","Level 3","614","49","435","97","57","1252"
201718,"Guildford","LADU","Level 2","38","40","165","68","32","343"
201718,"Guildford","LADU","All other qualifications","24","33","108","66","75","306"
201819,"Guildford","LADU","Total","633","115","618","233","145","1744"
201819,"Guildford","LADU","Level 3","551","44","346","90","43","1074"
201819,"Guildford","LADU","Level 2","55","44","199","79","43","420"
201819,"Guildford","LADU","All other qualifications","27","27","73","64","59","250"
201920,"Guildford","LADU","Total","631","71","613","206","113","1634"
201920,"Guildford","LADU","Level 3","561","28","402","100","52","1143"
201920,"Guildford","LADU","Level 2","38","19","122","46","18","243"
201920,"Guildford","LADU","All other qualifications","32","24","89","60","43","248"
202021,"Guildford","LADU","Total","409","49","293","142","58","951"
202021,"Guildford","LADU","Level 3","384","12","159","69","24","648"
202021,"Guildford","LADU","Level 2","6","13","59","30","13","121"
202021,"Guildford","LADU","All other qualifications","19","24","75","43","21","182"
201718,"Hart","LADU","Total","77","11","54","14","5","161"
201718,"Hart","LADU","Level 3","77","11","48","8","3","147"
201718,"Hart","LADU","Level 2","0","0","4","1","1","6"
201718,"Hart","LADU","All other qualifications","0","0","2","5","1","8"
201819,"Hart","LADU","Total","71","7","53","12","2","145"
201819,"Hart","LADU","Level 3","70","5","40","9","1","125"
201819,"Hart","LADU","Level 2","1","2","8","3","0","14"
201819,"Hart","LADU","All other qualifications","0","0","5","0","1","6"
201920,"Hart","LADU","Total","54","6","35","16","4","115"
201920,"Hart","LADU","Level 3","51","5","30","10","1","97"
201920,"Hart","LADU","Level 2","3","1","4","3","1","12"
201920,"Hart","LADU","All other qualifications","0","0","1","3","2","6"
202021,"Hart","LADU","Total","57","4","28","8","2","99"
202021,"Hart","LADU","Level 3","53","4","22","4","1","84"
202021,"Hart","LADU","Level 2","4","0","4","1","0","9"
202021,"Hart","LADU","All other qualifications","0","0","2","3","1","6"
201718,"Hastings","LADU","Total","339","81","289","213","118","1040"
201718,"Hastings","LADU","Level 3","226","34","151","68","47","526"
201718,"Hastings","LADU","Level 2","59","27","91","55","37","269"
201718,"Hastings","LADU","All other qualifications","54","20","47","90","34","245"
201819,"Hastings","LADU","Total","383","63","312","224","110","1092"
201819,"Hastings","LADU","Level 3","202","25","143","55","44","469"
201819,"Hastings","LADU","Level 2","129","20","121","80","30","380"
201819,"Hastings","LADU","All other qualifications","52","18","48","89","36","243"
201920,"Hastings","LADU","Total","735","88","479","261","119","1682"
201920,"Hastings","LADU","Level 3","584","36","321","92","53","1086"
201920,"Hastings","LADU","Level 2","81","32","96","80","22","311"
201920,"Hastings","LADU","All other qualifications","70","20","62","89","44","285"
202021,"Hastings","LADU","Total","29","0","10","4","5","48"
202021,"Hastings","LADU","Level 3","28","0","9","4","3","44"
202021,"Hastings","LADU","Level 2","0","0","1","0","2","3"
202021,"Hastings","LADU","All other qualifications","1","0","0","0","0","1"
201718,"Havant","LADU","Total","1114","230","773","256","97","2470"
201718,"Havant","LADU","Level 3","939","139","577","137","52","1844"
201718,"Havant","LADU","Level 2","124","41","131","46","21","363"
201718,"Havant","LADU","All other qualifications","51","50","65","73","24","263"
201819,"Havant","LADU","Total","1040","206","690","234","91","2261"
201819,"Havant","LADU","Level 3","807","109","437","85","43","1481"
201819,"Havant","LADU","Level 2","174","46","134","60","19","433"
201819,"Havant","LADU","All other qualifications","59","51","119","89","29","347"
201920,"Havant","LADU","Total","623","169","573","208","77","1650"
201920,"Havant","LADU","Level 3","579","88","401","89","32","1189"
201920,"Havant","LADU","Level 2","21","37","74","54","16","202"
201920,"Havant","LADU","All other qualifications","23","44","98","65","29","259"
202021,"Havant","LADU","Total","1233","146","742","352","97","2570"
202021,"Havant","LADU","Level 3","915","77","503","165","51","1711"
202021,"Havant","LADU","Level 2","182","26","111","74","17","410"
202021,"Havant","LADU","All other qualifications","136","43","128","113","29","449"
201718,"Horsham","LADU","Total","677","70","367","93","56","1263"
201718,"Horsham","LADU","Level 3","663","55","332","77","44","1171"
201718,"Horsham","LADU","Level 2","8","5","17","8","7","45"
201718,"Horsham","LADU","All other qualifications","6","10","18","8","5","47"
201819,"Horsham","LADU","Total","728","74","423","98","57","1380"
201819,"Horsham","LADU","Level 3","677","62","386","80","47","1252"
201819,"Horsham","LADU","Level 2","43","8","16","9","5","81"
201819,"Horsham","LADU","All other qualifications","8","4","21","9","5","47"
201920,"Horsham","LADU","Total","706","57","414","110","59","1346"
201920,"Horsham","LADU","Level 3","669","45","350","78","51","1193"
201920,"Horsham","LADU","Level 2","23","5","31","12","4","75"
201920,"Horsham","LADU","All other qualifications","14","7","33","20","4","78"
202021,"Horsham","LADU","Total","707","55","346","121","72","1301"
202021,"Horsham","LADU","Level 3","669","39","295","91","62","1156"
202021,"Horsham","LADU","Level 2","26","8","22","14","2","72"
202021,"Horsham","LADU","All other qualifications","12","8","29","16","8","73"
201718,"Isle of Wight","LADU","Total","448","118","337","219","76","1198"
201718,"Isle of Wight","LADU","Level 3","380","52","185","92","38","747"
201718,"Isle of Wight","LADU","Level 2","43","40","104","51","18","256"
201718,"Isle of Wight","LADU","All other qualifications","25","26","48","76","20","195"
201819,"Isle of Wight","LADU","Total","505","125","322","228","80","1260"
201819,"Isle of Wight","LADU","Level 3","374","41","145","71","38","669"
201819,"Isle of Wight","LADU","Level 2","85","51","110","79","19","344"
201819,"Isle of Wight","LADU","All other qualifications","46","33","67","78","23","247"
201920,"Isle of Wight","LADU","Total","407","133","326","206","60","1132"
201920,"Isle of Wight","LADU","Level 3","332","49","186","78","32","677"
201920,"Isle of Wight","LADU","Level 2","52","52","76","53","12","245"
201920,"Isle of Wight","LADU","All other qualifications","23","32","64","75","16","210"
202021,"Isle of Wight","LADU","Total","581","60","314","208","56","1219"
202021,"Isle of Wight","LADU","Level 3","384","23","164","78","20","669"
202021,"Isle of Wight","LADU","Level 2","131","17","79","54","14","295"
202021,"Isle of Wight","LADU","All other qualifications","66","20","71","76","22","255"
201718,"Lewes","LADU","Total","175","35","192","101","71","574"
201718,"Lewes","LADU","Level 3","91","17","106","32","21","267"
201718,"Lewes","LADU","Level 2","49","12","61","36","22","180"
201718,"Lewes","LADU","All other qualifications","35","6","25","33","28","127"
201819,"Lewes","LADU","Total","168","33","169","88","37","495"
201819,"Lewes","LADU","Level 3","103","14","88","29","10","244"
201819,"Lewes","LADU","Level 2","42","13","58","42","9","164"
201819,"Lewes","LADU","All other qualifications","23","6","23","17","18","87"
201920,"Lewes","LADU","Total","178","23","184","101","54","540"
201920,"Lewes","LADU","Level 3","100","8","95","37","21","261"
201920,"Lewes","LADU","Level 2","39","9","61","36","16","161"
201920,"Lewes","LADU","All other qualifications","39","6","28","28","17","118"
202021,"Lewes","LADU","Total","194","30","132","105","46","507"
202021,"Lewes","LADU","Level 3","105","10","70","44","14","243"
202021,"Lewes","LADU","Level 2","53","9","41","32","13","148"
202021,"Lewes","LADU","All other qualifications","36","11","21","29","19","116"
201718,"Maidstone","LADU","Total","645","82","320","81","23","1151"
201718,"Maidstone","LADU","Level 3","640","72","306","72","20","1110"
201718,"Maidstone","LADU","Level 2","5","3","7","8","3","26"
201718,"Maidstone","LADU","All other qualifications","0","7","7","1","0","15"
201819,"Maidstone","LADU","Total","717","83","291","67","36","1194"
201819,"Maidstone","LADU","Level 3","708","78","276","55","29","1146"
201819,"Maidstone","LADU","Level 2","9","3","7","7","5","31"
201819,"Maidstone","LADU","All other qualifications","0","2","8","5","2","17"
201920,"Maidstone","LADU","Total","686","73","303","91","46","1199"
201920,"Maidstone","LADU","Level 3","681","64","284","73","36","1138"
201920,"Maidstone","LADU","Level 2","1","4","9","14","4","32"
201920,"Maidstone","LADU","All other qualifications","4","5","10","4","6","29"
202021,"Maidstone","LADU","Total","657","64","284","115","37","1157"
202021,"Maidstone","LADU","Level 3","653","52","260","98","32","1095"
202021,"Maidstone","LADU","Level 2","3","6","9","11","2","31"
202021,"Maidstone","LADU","All other qualifications","1","6","15","6","3","31"
201718,"Medway","LADU","Total","1329","462","1151","637","290","3869"
201718,"Medway","LADU","Level 3","1181","193","654","215","101","2344"
201718,"Medway","LADU","Level 2","95","143","307","198","78","821"
201718,"Medway","LADU","All other qualifications","53","126","190","224","111","704"
201819,"Medway","LADU","Total","1419","444","1208","719","274","4064"
201819,"Medway","LADU","Level 3","1074","198","615","210","77","2174"
201819,"Medway","LADU","Level 2","263","144","383","243","89","1122"
201819,"Medway","LADU","All other qualifications","82","102","210","266","108","768"
201920,"Medway","LADU","Total","1408","383","896","525","221","3433"
201920,"Medway","LADU","Level 3","1043","153","463","143","58","1860"
201920,"Medway","LADU","Level 2","271","146","261","192","76","946"
201920,"Medway","LADU","All other qualifications","94","84","172","190","87","627"
202021,"Medway","LADU","Total","1500","295","958","725","211","3689"
202021,"Medway","LADU","Level 3","1104","104","465","247","59","1979"
202021,"Medway","LADU","Level 2","286","99","303","229","57","974"
202021,"Medway","LADU","All other qualifications","110","92","190","249","95","736"
201718,"Mid Sussex","LADU","Total","246","32","172","41","17","508"
201718,"Mid Sussex","LADU","Level 3","243","27","155","34","15","474"
201718,"Mid Sussex","LADU","Level 2","3","4","13","6","1","27"
201718,"Mid Sussex","LADU","All other qualifications","0","1","4","1","1","7"
201819,"Mid Sussex","LADU","Total","257","28","155","39","17","496"
201819,"Mid Sussex","LADU","Level 3","249","25","142","29","15","460"
201819,"Mid Sussex","LADU","Level 2","8","2","13","7","1","31"
201819,"Mid Sussex","LADU","All other qualifications","0","1","0","3","1","5"
201920,"Mid Sussex","LADU","Total","229","29","165","38","17","478"
201920,"Mid Sussex","LADU","Level 3","221","26","146","32","11","436"
201920,"Mid Sussex","LADU","Level 2","8","2","11","3","2","26"
201920,"Mid Sussex","LADU","All other qualifications","0","1","8","3","4","16"
202021,"Mid Sussex","LADU","Total","250","17","158","38","19","482"
202021,"Mid Sussex","LADU","Level 3","237","9","137","34","13","430"
202021,"Mid Sussex","LADU","Level 2","7","7","12","1","3","30"
202021,"Mid Sussex","LADU","All other qualifications","6","1","9","3","3","22"
201718,"Milton Keynes","LADU","Total","1390","186","806","296","135","2813"
201718,"Milton Keynes","LADU","Level 3","1153","95","472","118","69","1907"
201718,"Milton Keynes","LADU","Level 2","162","42","186","75","23","488"
201718,"Milton Keynes","LADU","All other qualifications","75","49","148","103","43","418"
201819,"Milton Keynes","LADU","Total","1223","183","795","290","115","2606"
201819,"Milton Keynes","LADU","Level 3","1107","102","474","128","53","1864"
201819,"Milton Keynes","LADU","Level 2","62","40","190","54","28","374"
201819,"Milton Keynes","LADU","All other qualifications","54","41","131","108","34","368"
201920,"Milton Keynes","LADU","Total","1458","194","899","379","134","3064"
201920,"Milton Keynes","LADU","Level 3","1196","101","502","157","68","2024"
201920,"Milton Keynes","LADU","Level 2","169","48","237","103","30","587"
201920,"Milton Keynes","LADU","All other qualifications","93","45","160","119","36","453"
202021,"Milton Keynes","LADU","Total","1453","145","703","383","113","2797"
202021,"Milton Keynes","LADU","Level 3","1211","64","393","153","54","1875"
202021,"Milton Keynes","LADU","Level 2","152","37","187","103","24","503"
202021,"Milton Keynes","LADU","All other qualifications","90","44","123","127","35","419"
201718,"Mole Valley","LADU","Total","194","21","104","31","15","365"
201718,"Mole Valley","LADU","Level 3","189","17","93","27","10","336"
201718,"Mole Valley","LADU","Level 2","4","2","6","2","2","16"
201718,"Mole Valley","LADU","All other qualifications","1","2","5","2","3","13"
201819,"Mole Valley","LADU","Total","199","16","89","21","14","339"
201819,"Mole Valley","LADU","Level 3","198","14","82","16","10","320"
201819,"Mole Valley","LADU","Level 2","1","2","6","4","2","15"
201819,"Mole Valley","LADU","All other qualifications","0","0","1","1","2","4"
201920,"Mole Valley","LADU","Total","162","9","77","26","13","287"
201920,"Mole Valley","LADU","Level 3","159","6","68","21","9","263"
201920,"Mole Valley","LADU","Level 2","2","1","7","4","1","15"
201920,"Mole Valley","LADU","All other qualifications","1","2","2","1","3","9"
202021,"Mole Valley","LADU","Total","222","12","63","22","14","333"
202021,"Mole Valley","LADU","Level 3","217","9","57","16","13","312"
202021,"Mole Valley","LADU","Level 2","4","0","3","6","1","14"
202021,"Mole Valley","LADU","All other qualifications","1","3","3","0","0","7"
201718,"New Forest","LADU","Total","779","199","711","258","145","2092"
201718,"New Forest","LADU","Level 3","708","98","528","145","88","1567"
201718,"New Forest","LADU","Level 2","39","62","111","58","22","292"
201718,"New Forest","LADU","All other qualifications","32","39","72","55","35","233"
201819,"New Forest","LADU","Total","777","151","604","235","111","1878"
201819,"New Forest","LADU","Level 3","641","82","395","112","75","1305"
201819,"New Forest","LADU","Level 2","73","43","134","51","11","312"
201819,"New Forest","LADU","All other qualifications","63","26","75","72","25","261"
201920,"New Forest","LADU","Total","688","135","591","241","106","1761"
201920,"New Forest","LADU","Level 3","613","77","437","126","80","1333"
201920,"New Forest","LADU","Level 2","42","35","87","49","10","223"
201920,"New Forest","LADU","All other qualifications","33","23","67","66","16","205"
202021,"New Forest","LADU","Total","762","107","495","237","110","1711"
202021,"New Forest","LADU","Level 3","615","52","364","122","77","1230"
202021,"New Forest","LADU","Level 2","90","34","62","48","10","244"
202021,"New Forest","LADU","All other qualifications","57","21","69","67","23","237"
201718,"Oxford","LADU","Total","1174","294","1212","520","222","3422"
201718,"Oxford","LADU","Level 3","828","127","638","217","93","1903"
201718,"Oxford","LADU","Level 2","210","74","282","122","48","736"
201718,"Oxford","LADU","All other qualifications","136","93","292","181","81","783"
201819,"Oxford","LADU","Total","783","254","1238","467","208","2950"
201819,"Oxford","LADU","Level 3","590","89","536","131","72","1418"
201819,"Oxford","LADU","Level 2","132","83","448","163","53","879"
201819,"Oxford","LADU","All other qualifications","61","82","254","173","83","653"
201920,"Oxford","LADU","Total","938","238","1346","521","220","3263"
201920,"Oxford","LADU","Level 3","717","85","663","158","78","1701"
201920,"Oxford","LADU","Level 2","142","92","428","190","62","914"
201920,"Oxford","LADU","All other qualifications","79","61","255","173","80","648"
202021,"Oxford","LADU","Total","1895","269","1542","819","329","4854"
202021,"Oxford","LADU","Level 3","1109","75","810","299","112","2405"
202021,"Oxford","LADU","Level 2","575","107","461","322","86","1551"
202021,"Oxford","LADU","All other qualifications","211","87","271","198","131","898"
201718,"Portsmouth","LADU","Total","346","197","344","217","107","1211"
201718,"Portsmouth","LADU","Level 3","250","87","181","61","27","606"
201718,"Portsmouth","LADU","Level 2","38","65","103","55","27","288"
201718,"Portsmouth","LADU","All other qualifications","58","45","60","101","53","317"
201819,"Portsmouth","LADU","Total","346","134","420","216","126","1242"
201819,"Portsmouth","LADU","Level 3","286","50","213","46","26","621"
201819,"Portsmouth","LADU","Level 2","33","47","137","73","39","329"
201819,"Portsmouth","LADU","All other qualifications","27","37","70","97","61","292"
201920,"Portsmouth","LADU","Total","464","166","387","270","93","1380"
201920,"Portsmouth","LADU","Level 3","329","75","245","98","29","776"
201920,"Portsmouth","LADU","Level 2","59","50","92","65","19","285"
201920,"Portsmouth","LADU","All other qualifications","76","41","50","107","45","319"
202021,"Portsmouth","LADU","Total","686","148","409","289","117","1649"
202021,"Portsmouth","LADU","Level 3","496","67","249","112","51","975"
202021,"Portsmouth","LADU","Level 2","103","30","99","68","22","322"
202021,"Portsmouth","LADU","All other qualifications","87","51","61","109","44","352"
201718,"Reading","LADU","Total","467","67","140","71","38","783"
201718,"Reading","LADU","Level 3","458","52","128","57","27","722"
201718,"Reading","LADU","Level 2","7","9","8","10","7","41"
201718,"Reading","LADU","All other qualifications","2","6","4","4","4","20"
201819,"Reading","LADU","Total","459","39","147","50","36","731"
201819,"Reading","LADU","Level 3","447","29","123","41","25","665"
201819,"Reading","LADU","Level 2","9","5","17","7","8","46"
201819,"Reading","LADU","All other qualifications","3","5","7","2","3","20"
201920,"Reading","LADU","Total","447","36","117","44","30","674"
201920,"Reading","LADU","Level 3","436","32","102","38","24","632"
201920,"Reading","LADU","Level 2","3","3","7","3","1","17"
201920,"Reading","LADU","All other qualifications","8","1","8","3","5","25"
202021,"Reading","LADU","Total","451","26","101","56","43","677"
202021,"Reading","LADU","Level 3","431","17","80","46","36","610"
202021,"Reading","LADU","Level 2","16","3","12","5","4","40"
202021,"Reading","LADU","All other qualifications","4","6","9","5","3","27"
201718,"Reigate and Banstead","LADU","Total","830","140","562","191","91","1814"
201718,"Reigate and Banstead","LADU","Level 3","784","88","440","107","42","1461"
201718,"Reigate and Banstead","LADU","Level 2","19","27","55","25","10","136"
201718,"Reigate and Banstead","LADU","All other qualifications","27","25","67","59","39","217"
201819,"Reigate and Banstead","LADU","Total","1066","205","882","292","162","2607"
201819,"Reigate and Banstead","LADU","Level 3","838","100","540","121","71","1670"
201819,"Reigate and Banstead","LADU","Level 2","174","68","252","76","43","613"
201819,"Reigate and Banstead","LADU","All other qualifications","54","37","90","95","48","324"
201920,"Reigate and Banstead","LADU","Total","1062","190","811","272","143","2478"
201920,"Reigate and Banstead","LADU","Level 3","896","94","580","139","72","1781"
201920,"Reigate and Banstead","LADU","Level 2","108","58","128","43","17","354"
201920,"Reigate and Banstead","LADU","All other qualifications","58","38","103","90","54","343"
202021,"Reigate and Banstead","LADU","Total","1301","120","696","356","160","2633"
202021,"Reigate and Banstead","LADU","Level 3","999","59","498","191","76","1823"
202021,"Reigate and Banstead","LADU","Level 2","175","28","106","61","29","399"
202021,"Reigate and Banstead","LADU","All other qualifications","127","33","92","104","55","411"
201718,"Rother","LADU","Total","474","40","236","95","50","895"
201718,"Rother","LADU","Level 3","398","29","185","52","40","704"
201718,"Rother","LADU","Level 2","68","4","40","33","7","152"
201718,"Rother","LADU","All other qualifications","8","7","11","10","3","39"
201819,"Rother","LADU","Total","464","42","237","100","51","894"
201819,"Rother","LADU","Level 3","366","30","184","55","36","671"
201819,"Rother","LADU","Level 2","87","4","35","24","7","157"
201819,"Rother","LADU","All other qualifications","11","8","18","21","8","66"
201920,"Rother","LADU","Total","451","23","243","115","68","900"
201920,"Rother","LADU","Level 3","373","13","192","58","50","686"
201920,"Rother","LADU","Level 2","68","3","28","26","5","130"
201920,"Rother","LADU","All other qualifications","10","7","23","31","13","84"
202021,"Rother","LADU","Total","429","33","197","108","78","845"
202021,"Rother","LADU","Level 3","353","23","148","65","64","653"
202021,"Rother","LADU","Level 2","63","6","33","20","5","127"
202021,"Rother","LADU","All other qualifications","13","4","16","23","9","65"
201718,"Runnymede","LADU","Total","423","64","208","82","28","805"
201718,"Runnymede","LADU","Level 3","417","48","184","68","25","742"
201718,"Runnymede","LADU","Level 2","3","2","12","7","1","25"
201718,"Runnymede","LADU","All other qualifications","3","14","12","7","2","38"
201819,"Runnymede","LADU","Total","178","15","75","14","13","295"
201819,"Runnymede","LADU","Level 3","175","9","60","8","8","260"
201819,"Runnymede","LADU","Level 2","0","2","8","3","1","14"
201819,"Runnymede","LADU","All other qualifications","3","4","7","3","4","21"
201920,"Runnymede","LADU","Total","176","18","67","23","13","297"
201920,"Runnymede","LADU","Level 3","174","10","52","17","9","262"
201920,"Runnymede","LADU","Level 2","1","4","7","3","1","16"
201920,"Runnymede","LADU","All other qualifications","1","4","8","3","3","19"
202021,"Runnymede","LADU","Total","192","7","39","16","6","260"
202021,"Runnymede","LADU","Level 3","191","5","36","15","6","253"
202021,"Runnymede","LADU","Level 2","0","0","1","0","0","1"
202021,"Runnymede","LADU","All other qualifications","1","2","2","1","0","6"
201718,"Rushmoor","LADU","Total","1302","222","824","235","78","2661"
201718,"Rushmoor","LADU","Level 3","1233","114","599","143","47","2136"
201718,"Rushmoor","LADU","Level 2","36","65","145","53","11","310"
201718,"Rushmoor","LADU","All other qualifications","33","43","80","39","20","215"
201819,"Rushmoor","LADU","Total","1211","190","863","232","86","2582"
201819,"Rushmoor","LADU","Level 3","1136","107","599","122","53","2017"
201819,"Rushmoor","LADU","Level 2","60","51","185","66","18","380"
201819,"Rushmoor","LADU","All other qualifications","15","32","79","44","15","185"
201920,"Rushmoor","LADU","Total","1400","197","846","251","81","2775"
201920,"Rushmoor","LADU","Level 3","1342","101","605","136","46","2230"
201920,"Rushmoor","LADU","Level 2","31","57","139","46","15","288"
201920,"Rushmoor","LADU","All other qualifications","27","39","102","69","20","257"
202021,"Rushmoor","LADU","Total","1478","158","795","309","92","2832"
202021,"Rushmoor","LADU","Level 3","1307","77","568","167","55","2174"
202021,"Rushmoor","LADU","Level 2","105","36","132","66","16","355"
202021,"Rushmoor","LADU","All other qualifications","66","45","95","76","21","303"
201718,"Sevenoaks","LADU","Total","49","7","42","5","6","109"
201718,"Sevenoaks","LADU","Level 3","42","6","37","3","5","93"
201718,"Sevenoaks","LADU","Level 2","5","1","4","1","0","11"
201718,"Sevenoaks","LADU","All other qualifications","2","0","1","1","1","5"
201819,"Sevenoaks","LADU","Total","32","16","43","11","6","108"
201819,"Sevenoaks","LADU","Level 3","28","12","34","5","3","82"
201819,"Sevenoaks","LADU","Level 2","3","3","9","2","3","20"
201819,"Sevenoaks","LADU","All other qualifications","1","1","0","4","0","6"
201920,"Sevenoaks","LADU","Total","37","9","32","7","3","88"
201920,"Sevenoaks","LADU","Level 3","36","7","28","5","1","77"
201920,"Sevenoaks","LADU","Level 2","0","2","3","2","1","8"
201920,"Sevenoaks","LADU","All other qualifications","1","0","1","0","1","3"
202021,"Sevenoaks","LADU","Total","65","5","35","17","6","128"
202021,"Sevenoaks","LADU","Level 3","63","4","32","16","6","121"
202021,"Sevenoaks","LADU","Level 2","2","0","3","0","0","5"
202021,"Sevenoaks","LADU","All other qualifications","0","1","0","1","0","2"
201718,"Slough","LADU","Total","1131","125","414","214","126","2010"
201718,"Slough","LADU","Level 3","971","60","224","90","40","1385"
201718,"Slough","LADU","Level 2","97","37","98","64","31","327"
201718,"Slough","LADU","All other qualifications","63","28","92","60","55","298"
201819,"Slough","LADU","Total","1390","177","519","306","163","2555"
201819,"Slough","LADU","Level 3","1168","96","316","150","66","1796"
201819,"Slough","LADU","Level 2","132","42","118","67","39","398"
201819,"Slough","LADU","All other qualifications","90","39","85","89","58","361"
201920,"Slough","LADU","Total","1432","135","522","272","158","2519"
201920,"Slough","LADU","Level 3","1226","70","351","121","57","1825"
201920,"Slough","LADU","Level 2","110","33","76","51","33","303"
201920,"Slough","LADU","All other qualifications","96","32","95","100","68","391"
202021,"Slough","LADU","Total","1490","107","403","351","165","2516"
202021,"Slough","LADU","Level 3","1232","45","253","169","78","1777"
202021,"Slough","LADU","Level 2","135","24","51","52","20","282"
202021,"Slough","LADU","All other qualifications","123","38","99","130","67","457"
201718,"South Bucks","LADU","Total","267","11","41","12","9","340"
201718,"South Bucks","LADU","Level 3","267","10","39","10","7","333"
201718,"South Bucks","LADU","Level 2","0","1","1","2","2","6"
201718,"South Bucks","LADU","All other qualifications","0","0","1","0","0","1"
201819,"South Bucks","LADU","Total","234","6","38","13","15","306"
201819,"South Bucks","LADU","Level 3","233","6","38","13","13","303"
201819,"South Bucks","LADU","Level 2","1","0","0","0","0","1"
201819,"South Bucks","LADU","All other qualifications","0","0","0","0","2","2"
201920,"South Bucks","LADU","Total","239","12","26","10","11","298"
201920,"South Bucks","LADU","Level 3","238","11","26","10","10","295"
201920,"South Bucks","LADU","Level 2","1","0","0","0","0","1"
201920,"South Bucks","LADU","All other qualifications","0","1","0","0","1","2"
202021,"South Bucks","LADU","Total","262","10","41","28","12","353"
202021,"South Bucks","LADU","Level 3","262","8","40","26","12","348"
202021,"South Bucks","LADU","All other qualifications","0","2","1","2","0","5"
201718,"South Oxfordshire","LADU","Total","711","109","430","135","45","1430"
201718,"South Oxfordshire","LADU","Level 3","697","89","392","115","37","1330"
201718,"South Oxfordshire","LADU","Level 2","4","12","23","9","2","50"
201718,"South Oxfordshire","LADU","All other qualifications","10","8","15","11","6","50"
201819,"South Oxfordshire","LADU","Total","736","105","506","127","65","1539"
201819,"South Oxfordshire","LADU","Level 3","718","74","451","102","44","1389"
201819,"South Oxfordshire","LADU","Level 2","7","14","30","14","8","73"
201819,"South Oxfordshire","LADU","All other qualifications","11","17","25","11","13","77"
201920,"South Oxfordshire","LADU","Total","764","91","462","167","77","1561"
201920,"South Oxfordshire","LADU","Level 3","728","68","365","124","48","1333"
201920,"South Oxfordshire","LADU","Level 2","13","12","33","19","10","87"
201920,"South Oxfordshire","LADU","All other qualifications","23","11","64","24","19","141"
202021,"South Oxfordshire","LADU","Total","723","69","409","162","80","1443"
202021,"South Oxfordshire","LADU","Level 3","690","39","320","116","54","1219"
202021,"South Oxfordshire","LADU","Level 2","18","12","26","17","4","77"
202021,"South Oxfordshire","LADU","All other qualifications","15","18","63","29","22","147"
201718,"Southampton","LADU","Total","732","194","669","275","125","1995"
201718,"Southampton","LADU","Level 3","611","90","433","112","47","1293"
201718,"Southampton","LADU","Level 2","75","51","147","78","32","383"
201718,"Southampton","LADU","All other qualifications","46","53","89","85","46","319"
201819,"Southampton","LADU","Total","731","156","642","284","137","1950"
201819,"Southampton","LADU","Level 3","578","66","384","108","79","1215"
201819,"Southampton","LADU","Level 2","118","54","169","78","26","445"
201819,"Southampton","LADU","All other qualifications","35","36","89","98","32","290"
201920,"Southampton","LADU","Total","634","174","566","303","155","1832"
201920,"Southampton","LADU","Level 3","501","64","344","106","69","1084"
201920,"Southampton","LADU","Level 2","72","60","119","91","32","374"
201920,"Southampton","LADU","All other qualifications","61","50","103","106","54","374"
202021,"Southampton","LADU","Total","780","119","458","317","155","1829"
202021,"Southampton","LADU","Level 3","571","40","278","119","72","1080"
202021,"Southampton","LADU","Level 2","141","41","100","97","39","418"
202021,"Southampton","LADU","All other qualifications","68","38","80","101","44","331"
201718,"Spelthorne","LADU","Total","97","6","46","11","6","166"
201718,"Spelthorne","LADU","Level 3","97","6","45","11","6","165"
201718,"Spelthorne","LADU","Level 2","0","0","1","0","0","1"
201819,"Spelthorne","LADU","Total","105","13","43","10","6","177"
201819,"Spelthorne","LADU","Level 3","105","11","41","9","6","172"
201819,"Spelthorne","LADU","Level 2","0","0","0","1","0","1"
201819,"Spelthorne","LADU","All other qualifications","0","2","2","0","0","4"
201920,"Spelthorne","LADU","Total","107","10","40","11","4","172"
201920,"Spelthorne","LADU","Level 3","107","10","38","8","3","166"
201920,"Spelthorne","LADU","Level 2","0","0","0","1","0","1"
201920,"Spelthorne","LADU","All other qualifications","0","0","2","2","1","5"
202021,"Spelthorne","LADU","Total","95","8","34","16","8","161"
202021,"Spelthorne","LADU","Level 3","91","4","31","10","7","143"
202021,"Spelthorne","LADU","Level 2","0","0","0","1","0","1"
202021,"Spelthorne","LADU","All other qualifications","4","4","3","5","1","17"
201718,"Surrey Heath","LADU","Total","173","39","113","40","17","382"
201718,"Surrey Heath","LADU","Level 3","170","24","76","31","12","313"
201718,"Surrey Heath","LADU","Level 2","3","15","31","9","2","60"
201718,"Surrey Heath","LADU","All other qualifications","0","0","6","0","3","9"
201819,"Surrey Heath","LADU","Total","175","22","104","36","13","350"
201819,"Surrey Heath","LADU","Level 3","170","16","82","21","7","296"
201819,"Surrey Heath","LADU","Level 2","4","3","19","13","4","43"
201819,"Surrey Heath","LADU","All other qualifications","1","3","3","2","2","11"
201920,"Surrey Heath","LADU","Total","174","19","95","19","9","316"
201920,"Surrey Heath","LADU","Level 3","173","18","80","11","9","291"
201920,"Surrey Heath","LADU","Level 2","1","1","12","7","0","21"
201920,"Surrey Heath","LADU","All other qualifications","0","0","3","1","0","4"
202021,"Surrey Heath","LADU","Total","160","11","41","26","12","250"
202021,"Surrey Heath","LADU","Level 3","159","7","34","23","12","235"
202021,"Surrey Heath","LADU","Level 2","0","1","3","2","0","6"
202021,"Surrey Heath","LADU","All other qualifications","1","3","4","1","0","9"
201718,"Swale","LADU","Total","407","72","229","91","36","835"
201718,"Swale","LADU","Level 3","398","56","208","64","26","752"
201718,"Swale","LADU","Level 2","7","7","15","18","5","52"
201718,"Swale","LADU","All other qualifications","2","9","6","9","5","31"
201819,"Swale","LADU","Total","418","67","205","73","39","802"
201819,"Swale","LADU","Level 3","400","59","177","54","29","719"
201819,"Swale","LADU","Level 2","14","6","23","12","10","65"
201819,"Swale","LADU","All other qualifications","4","2","5","7","0","18"
201920,"Swale","LADU","Total","357","67","202","85","22","733"
201920,"Swale","LADU","Level 3","345","50","171","64","16","646"
201920,"Swale","LADU","Level 2","7","8","21","11","4","51"
201920,"Swale","LADU","All other qualifications","5","9","10","10","2","36"
202021,"Swale","LADU","Total","369","46","181","90","37","723"
202021,"Swale","LADU","Level 3","349","31","151","71","29","631"
202021,"Swale","LADU","Level 2","15","9","19","11","3","57"
202021,"Swale","LADU","All other qualifications","5","6","11","8","5","35"
201718,"Tandridge","LADU","Total","160","25","117","27","16","345"
201718,"Tandridge","LADU","Level 3","160","25","109","26","14","334"
201718,"Tandridge","LADU","Level 2","0","0","4","1","0","5"
201718,"Tandridge","LADU","All other qualifications","0","0","4","0","2","6"
201819,"Tandridge","LADU","Total","142","17","106","23","29","317"
201819,"Tandridge","LADU","Level 3","141","17","104","23","23","308"
201819,"Tandridge","LADU","Level 2","1","0","1","0","1","3"
201819,"Tandridge","LADU","All other qualifications","0","0","1","0","5","6"
201920,"Tandridge","LADU","Total","127","21","75","15","16","254"
201920,"Tandridge","LADU","Level 3","124","16","70","13","15","238"
201920,"Tandridge","LADU","Level 2","0","2","2","0","1","5"
201920,"Tandridge","LADU","All other qualifications","3","3","3","2","0","11"
202021,"Tandridge","LADU","Total","115","10","70","24","11","230"
202021,"Tandridge","LADU","Level 3","114","5","61","21","11","212"
202021,"Tandridge","LADU","Level 2","0","1","1","0","0","2"
202021,"Tandridge","LADU","All other qualifications","1","4","8","3","0","16"
201819,"Test Valley","LADU","Total","0","0","0","0","2","2"
201819,"Test Valley","LADU","All other qualifications","0","0","0","0","2","2"
201718,"Thanet","LADU","Total","634","122","387","281","175","1599"
201718,"Thanet","LADU","Level 3","471","37","186","69","62","825"
201718,"Thanet","LADU","Level 2","93","54","126","79","41","393"
201718,"Thanet","LADU","All other qualifications","70","31","75","133","72","381"
201819,"Thanet","LADU","Total","444","110","301","248","116","1219"
201819,"Thanet","LADU","Level 3","368","41","177","56","44","686"
201819,"Thanet","LADU","Level 2","36","31","71","65","20","223"
201819,"Thanet","LADU","All other qualifications","40","38","53","127","52","310"
201920,"Thanet","LADU","Total","763","158","782","573","181","2457"
201920,"Thanet","LADU","Level 3","588","47","418","177","62","1292"
201920,"Thanet","LADU","Level 2","102","64","219","162","43","590"
201920,"Thanet","LADU","All other qualifications","73","47","145","234","76","575"
202021,"Thanet","LADU","Total","1389","190","1100","913","234","3826"
202021,"Thanet","LADU","Level 3","868","58","524","240","80","1770"
202021,"Thanet","LADU","Level 2","327","82","367","308","67","1151"
202021,"Thanet","LADU","All other qualifications","194","50","209","365","87","905"
201718,"Tonbridge and Malling","LADU","Total","898","161","768","363","193","2383"
201718,"Tonbridge and Malling","LADU","Level 3","723","70","465","126","60","1444"
201718,"Tonbridge and Malling","LADU","Level 2","112","44","146","95","44","441"
201718,"Tonbridge and Malling","LADU","All other qualifications","63","47","157","142","89","498"
201819,"Tonbridge and Malling","LADU","Total","936","171","790","359","180","2436"
201819,"Tonbridge and Malling","LADU","Level 3","695","47","383","105","46","1276"
201819,"Tonbridge and Malling","LADU","Level 2","151","66","237","93","49","596"
201819,"Tonbridge and Malling","LADU","All other qualifications","90","58","170","161","85","564"
201920,"Tonbridge and Malling","LADU","Total","754","146","712","335","147","2094"
201920,"Tonbridge and Malling","LADU","Level 3","650","60","415","105","47","1277"
201920,"Tonbridge and Malling","LADU","Level 2","50","45","153","76","37","361"
201920,"Tonbridge and Malling","LADU","All other qualifications","54","41","144","154","63","456"
202021,"Tonbridge and Malling","LADU","Total","914","136","656","390","146","2242"
202021,"Tonbridge and Malling","LADU","Level 3","735","48","342","146","62","1333"
202021,"Tonbridge and Malling","LADU","Level 2","103","36","157","87","32","415"
202021,"Tonbridge and Malling","LADU","All other qualifications","76","52","157","157","52","494"
201718,"Tunbridge Wells","LADU","Total","613","32","264","65","34","1008"
201718,"Tunbridge Wells","LADU","Level 3","612","31","257","64","30","994"
201718,"Tunbridge Wells","LADU","Level 2","0","1","4","0","1","6"
201718,"Tunbridge Wells","LADU","All other qualifications","1","0","3","1","3","8"
201819,"Tunbridge Wells","LADU","Total","592","34","230","52","38","946"
201819,"Tunbridge Wells","LADU","Level 3","591","30","223","48","32","924"
201819,"Tunbridge Wells","LADU","Level 2","1","0","3","3","4","11"
201819,"Tunbridge Wells","LADU","All other qualifications","0","4","4","1","2","11"
201920,"Tunbridge Wells","LADU","Total","636","27","244","78","40","1025"
201920,"Tunbridge Wells","LADU","Level 3","632","25","236","71","35","999"
201920,"Tunbridge Wells","LADU","Level 2","0","0","2","1","4","7"
201920,"Tunbridge Wells","LADU","All other qualifications","4","2","6","6","1","19"
202021,"Tunbridge Wells","LADU","Total","662","13","169","75","51","970"
202021,"Tunbridge Wells","LADU","Level 3","656","9","163","67","41","936"
202021,"Tunbridge Wells","LADU","Level 2","1","2","1","1","6","11"
202021,"Tunbridge Wells","LADU","All other qualifications","5","2","5","7","4","23"
201718,"Vale of White Horse","LADU","Total","471","139","497","123","53","1283"
201718,"Vale of White Horse","LADU","Level 3","386","75","306","41","22","830"
201718,"Vale of White Horse","LADU","Level 2","44","41","121","43","13","262"
201718,"Vale of White Horse","LADU","All other qualifications","41","23","70","39","18","191"
201819,"Vale of White Horse","LADU","Total","462","123","468","139","59","1251"
201819,"Vale of White Horse","LADU","Level 3","368","69","246","49","17","749"
201819,"Vale of White Horse","LADU","Level 2","62","30","143","44","18","297"
201819,"Vale of White Horse","LADU","All other qualifications","32","24","79","46","24","205"
201920,"Vale of White Horse","LADU","Total","468","123","453","153","75","1272"
201920,"Vale of White Horse","LADU","Level 3","386","59","260","61","31","797"
201920,"Vale of White Horse","LADU","Level 2","44","30","118","36","17","245"
201920,"Vale of White Horse","LADU","All other qualifications","38","34","75","56","27","230"
202021,"Vale of White Horse","LADU","Total","618","99","445","190","77","1429"
202021,"Vale of White Horse","LADU","Level 3","492","40","260","74","40","906"
202021,"Vale of White Horse","LADU","Level 2","62","33","104","52","17","268"
202021,"Vale of White Horse","LADU","All other qualifications","64","26","81","64","20","255"
201718,"Waverley","LADU","Total","538","31","383","88","48","1088"
201718,"Waverley","LADU","Level 3","526","21","352","70","44","1013"
201718,"Waverley","LADU","Level 2","10","5","19","9","3","46"
201718,"Waverley","LADU","All other qualifications","2","5","12","9","1","29"
201819,"Waverley","LADU","Total","596","43","379","94","73","1185"
201819,"Waverley","LADU","Level 3","567","35","348","81","63","1094"
201819,"Waverley","LADU","Level 2","21","2","17","6","3","49"
201819,"Waverley","LADU","All other qualifications","8","6","14","7","7","42"
201920,"Waverley","LADU","Total","584","21","360","113","62","1140"
201920,"Waverley","LADU","Level 3","546","13","334","89","54","1036"
201920,"Waverley","LADU","Level 2","19","6","12","11","5","53"
201920,"Waverley","LADU","All other qualifications","19","2","14","13","3","51"
202021,"Waverley","LADU","Total","511","23","323","73","70","1000"
202021,"Waverley","LADU","Level 3","480","13","302","61","58","914"
202021,"Waverley","LADU","Level 2","17","5","5","5","2","34"
202021,"Waverley","LADU","All other qualifications","14","5","16","7","10","52"
201718,"Wealden","LADU","Total","378","30","165","44","53","670"
201718,"Wealden","LADU","Level 3","375","24","150","34","50","633"
201718,"Wealden","LADU","Level 2","3","4","11","4","1","23"
201718,"Wealden","LADU","All other qualifications","0","2","4","6","2","14"
201819,"Wealden","LADU","Total","298","39","198","55","55","645"
201819,"Wealden","LADU","Level 3","295","31","180","48","53","607"
201819,"Wealden","LADU","Level 2","3","5","14","4","0","26"
201819,"Wealden","LADU","All other qualifications","0","3","4","3","2","12"
201920,"Wealden","LADU","Total","310","32","192","50","34","618"
201920,"Wealden","LADU","Level 3","303","28","179","46","31","587"
201920,"Wealden","LADU","Level 2","3","0","7","1","1","12"
201920,"Wealden","LADU","All other qualifications","4","4","6","3","2","19"
202021,"Wealden","LADU","Total","338","23","157","50","27","595"
202021,"Wealden","LADU","Level 3","332","16","143","44","22","557"
202021,"Wealden","LADU","Level 2","1","3","4","3","1","12"
202021,"Wealden","LADU","All other qualifications","5","4","10","3","4","26"
201718,"West Berkshire","LADU","Total","648","154","503","115","60","1480"
201718,"West Berkshire","LADU","Level 3","622","99","388","67","34","1210"
201718,"West Berkshire","LADU","Level 2","17","27","60","14","4","122"
201718,"West Berkshire","LADU","All other qualifications","9","28","55","34","22","148"
201819,"West Berkshire","LADU","Total","704","114","434","129","43","1424"
201819,"West Berkshire","LADU","Level 3","657","80","326","72","24","1159"
201819,"West Berkshire","LADU","Level 2","32","19","56","17","10","134"
201819,"West Berkshire","LADU","All other qualifications","15","15","52","40","9","131"
201920,"West Berkshire","LADU","Total","590","113","443","139","46","1331"
201920,"West Berkshire","LADU","Level 3","532","80","340","79","24","1055"
201920,"West Berkshire","LADU","Level 2","35","14","53","24","11","137"
201920,"West Berkshire","LADU","All other qualifications","23","19","50","36","11","139"
202021,"West Berkshire","LADU","Total","668","79","398","150","60","1355"
202021,"West Berkshire","LADU","Level 3","603","52","299","94","34","1082"
202021,"West Berkshire","LADU","Level 2","36","10","36","16","7","105"
202021,"West Berkshire","LADU","All other qualifications","29","17","63","40","19","168"
201718,"West Oxfordshire","LADU","Total","329","24","155","43","20","571"
201718,"West Oxfordshire","LADU","Level 3","327","23","146","42","20","558"
201718,"West Oxfordshire","LADU","Level 2","2","1","4","0","0","7"
201718,"West Oxfordshire","LADU","All other qualifications","0","0","5","1","0","6"
201819,"West Oxfordshire","LADU","Total","281","37","172","37","25","552"
201819,"West Oxfordshire","LADU","Level 3","278","32","164","33","25","532"
201819,"West Oxfordshire","LADU","Level 2","2","3","7","2","0","14"
201819,"West Oxfordshire","LADU","All other qualifications","1","2","1","2","0","6"
201920,"West Oxfordshire","LADU","Total","314","39","201","48","26","628"
201920,"West Oxfordshire","LADU","Level 3","309","33","183","46","21","592"
201920,"West Oxfordshire","LADU","Level 2","2","4","12","1","3","22"
201920,"West Oxfordshire","LADU","All other qualifications","3","2","6","1","2","14"
202021,"West Oxfordshire","LADU","Total","307","22","145","37","24","535"
202021,"West Oxfordshire","LADU","Level 3","302","14","130","31","20","497"
202021,"West Oxfordshire","LADU","Level 2","0","3","7","2","1","13"
202021,"West Oxfordshire","LADU","All other qualifications","5","5","8","4","3","25"
201718,"Winchester","LADU","Total","1448","171","988","349","139","3095"
201718,"Winchester","LADU","Level 3","1352","105","778","235","84","2554"
201718,"Winchester","LADU","Level 2","66","33","121","54","25","299"
201718,"Winchester","LADU","All other qualifications","30","33","89","60","30","242"
201819,"Winchester","LADU","Total","1500","151","1121","329","140","3241"
201819,"Winchester","LADU","Level 3","1398","90","846","206","79","2619"
201819,"Winchester","LADU","Level 2","58","36","201","60","22","377"
201819,"Winchester","LADU","All other qualifications","44","25","74","63","39","245"
201920,"Winchester","LADU","Total","1552","120","1056","372","146","3246"
201920,"Winchester","LADU","Level 3","1409","75","791","220","90","2585"
201920,"Winchester","LADU","Level 2","79","21","159","63","24","346"
201920,"Winchester","LADU","All other qualifications","64","24","106","89","32","315"
202021,"Winchester","LADU","Total","1620","132","951","349","136","3188"
202021,"Winchester","LADU","Level 3","1461","70","740","214","81","2566"
202021,"Winchester","LADU","Level 2","98","22","112","59","17","308"
202021,"Winchester","LADU","All other qualifications","61","40","99","76","38","314"
201718,"Windsor and Maidenhead","LADU","Total","625","106","425","153","78","1387"
201718,"Windsor and Maidenhead","LADU","Level 3","564","56","306","83","45","1054"
201718,"Windsor and Maidenhead","LADU","Level 2","35","33","84","50","21","223"
201718,"Windsor and Maidenhead","LADU","All other qualifications","26","17","35","20","12","110"
201819,"Windsor and Maidenhead","LADU","Total","599","110","460","133","102","1404"
201819,"Windsor and Maidenhead","LADU","Level 3","541","60","284","65","61","1011"
201819,"Windsor and Maidenhead","LADU","Level 2","36","36","147","40","23","282"
201819,"Windsor and Maidenhead","LADU","All other qualifications","22","14","29","28","18","111"
201920,"Windsor and Maidenhead","LADU","Total","714","103","489","148","81","1535"
201920,"Windsor and Maidenhead","LADU","Level 3","669","62","372","88","44","1235"
201920,"Windsor and Maidenhead","LADU","Level 2","25","17","73","34","18","167"
201920,"Windsor and Maidenhead","LADU","All other qualifications","20","24","44","26","19","133"
202021,"Windsor and Maidenhead","LADU","Total","820","54","430","190","84","1578"
202021,"Windsor and Maidenhead","LADU","Level 3","708","24","328","99","50","1209"
202021,"Windsor and Maidenhead","LADU","Level 2","80","16","61","53","12","222"
202021,"Windsor and Maidenhead","LADU","All other qualifications","32","14","41","38","22","147"
201718,"Woking","LADU","Total","400","31","237","70","30","768"
201718,"Woking","LADU","Level 3","393","23","206","57","20","699"
201718,"Woking","LADU","Level 2","5","1","17","7","3","33"
201718,"Woking","LADU","All other qualifications","2","7","14","6","7","36"
201819,"Woking","LADU","Total","416","49","221","73","29","788"
201819,"Woking","LADU","Level 3","382","47","197","55","22","703"
201819,"Woking","LADU","Level 2","30","2","14","9","0","55"
201819,"Woking","LADU","All other qualifications","4","0","10","9","7","30"
201920,"Woking","LADU","Total","445","38","263","61","28","835"
201920,"Woking","LADU","Level 3","430","31","226","48","15","750"
201920,"Woking","LADU","Level 2","8","2","19","7","3","39"
201920,"Woking","LADU","All other qualifications","7","5","18","6","10","46"
202021,"Woking","LADU","Total","473","24","191","103","30","821"
202021,"Woking","LADU","Level 3","427","17","173","79","21","717"
202021,"Woking","LADU","Level 2","37","2","8","10","7","64"
202021,"Woking","LADU","All other qualifications","9","5","10","14","2","40"
201718,"Wokingham","LADU","Total","566","73","214","56","24","933"
201718,"Wokingham","LADU","Level 3","562","71","207","54","23","917"
201718,"Wokingham","LADU","Level 2","4","1","4","2","0","11"
201718,"Wokingham","LADU","All other qualifications","0","1","3","0","1","5"
201819,"Wokingham","LADU","Total","542","60","215","58","31","906"
201819,"Wokingham","LADU","Level 3","537","53","194","51","28","863"
201819,"Wokingham","LADU","Level 2","5","5","16","5","2","33"
201819,"Wokingham","LADU","All other qualifications","0","2","5","2","1","10"
201920,"Wokingham","LADU","Total","609","46","240","65","30","990"
201920,"Wokingham","LADU","Level 3","599","43","226","62","27","957"
201920,"Wokingham","LADU","Level 2","8","1","1","1","0","11"
201920,"Wokingham","LADU","All other qualifications","2","2","13","2","3","22"
202021,"Wokingham","LADU","Total","586","36","199","58","41","920"
202021,"Wokingham","LADU","Level 3","574","32","191","55","37","889"
202021,"Wokingham","LADU","Level 2","5","1","0","1","3","10"
202021,"Wokingham","LADU","All other qualifications","7","3","8","2","1","21"
201718,"Worthing","LADU","Total","459","129","520","220","101","1429"
201718,"Worthing","LADU","Level 3","382","73","332","92","53","932"
201718,"Worthing","LADU","Level 2","43","41","113","54","23","274"
201718,"Worthing","LADU","All other qualifications","34","15","75","74","25","223"
201819,"Worthing","LADU","Total","797","183","675","313","144","2112"
201819,"Worthing","LADU","Level 3","483","77","371","104","67","1102"
201819,"Worthing","LADU","Level 2","231","68","196","95","35","625"
201819,"Worthing","LADU","All other qualifications","83","38","108","114","42","385"
201920,"Worthing","LADU","Total","780","170","629","326","150","2055"
201920,"Worthing","LADU","Level 3","601","81","392","119","61","1254"
201920,"Worthing","LADU","Level 2","115","52","151","88","33","439"
201920,"Worthing","LADU","All other qualifications","64","37","86","119","56","362"
202021,"Worthing","LADU","Total","463","99","390","345","115","1412"
202021,"Worthing","LADU","Level 3","261","25","146","90","46","568"
202021,"Worthing","LADU","Level 2","123","37","149","128","28","465"
202021,"Worthing","LADU","All other qualifications","79","37","95","127","41","379"
201718,"Wycombe","LADU","Total","768","34","206","86","34","1128"
201718,"Wycombe","LADU","Level 3","756","31","197","81","32","1097"
201718,"Wycombe","LADU","Level 2","12","2","6","4","0","24"
201718,"Wycombe","LADU","All other qualifications","0","1","3","1","2","7"
201819,"Wycombe","LADU","Total","718","33","231","55","40","1077"
201819,"Wycombe","LADU","Level 3","702","26","225","48","35","1036"
201819,"Wycombe","LADU","Level 2","16","7","4","4","3","34"
201819,"Wycombe","LADU","All other qualifications","0","0","2","3","2","7"
201920,"Wycombe","LADU","Total","729","37","165","58","40","1029"
201920,"Wycombe","LADU","Level 3","722","30","153","53","37","995"
201920,"Wycombe","LADU","Level 2","4","2","5","2","0","13"
201920,"Wycombe","LADU","All other qualifications","3","5","7","3","3","21"
202021,"Wycombe","LADU","Total","755","21","179","69","42","1066"
202021,"Wycombe","LADU","Level 3","745","18","163","62","38","1026"
202021,"Wycombe","LADU","Level 2","8","1","11","4","0","24"
202021,"Wycombe","LADU","All other qualifications","2","2","5","3","4","16"
201718,"Bath and North East Somerset","LADU","Total","829","236","897","251","135","2348"
201718,"Bath and North East Somerset","LADU","Level 3","714","122","585","121","55","1597"
201718,"Bath and North East Somerset","LADU","Level 2","75","77","202","66","32","452"
201718,"Bath and North East Somerset","LADU","All other qualifications","40","37","110","64","48","299"
201819,"Bath and North East Somerset","LADU","Total","862","215","723","236","98","2134"
201819,"Bath and North East Somerset","LADU","Level 3","716","113","504","106","40","1479"
201819,"Bath and North East Somerset","LADU","Level 2","117","57","137","59","17","387"
201819,"Bath and North East Somerset","LADU","All other qualifications","29","45","82","71","41","268"
201920,"Bath and North East Somerset","LADU","Total","865","198","762","219","115","2159"
201920,"Bath and North East Somerset","LADU","Level 3","750","107","518","117","57","1549"
201920,"Bath and North East Somerset","LADU","Level 2","63","55","130","41","12","301"
201920,"Bath and North East Somerset","LADU","All other qualifications","52","36","114","61","46","309"
202021,"Bath and North East Somerset","LADU","Total","950","160","644","280","98","2132"
202021,"Bath and North East Somerset","LADU","Level 3","815","66","432","151","69","1533"
202021,"Bath and North East Somerset","LADU","Level 2","82","58","114","54","5","313"
202021,"Bath and North East Somerset","LADU","All other qualifications","53","36","98","75","24","286"
201718,"Bournemouth","LADU","Total","452","50","220","81","40","843"
201718,"Bournemouth","LADU","Level 3","446","44","201","68","34","793"
201718,"Bournemouth","LADU","Level 2","2","2","8","7","2","21"
201718,"Bournemouth","LADU","All other qualifications","4","4","11","6","4","29"
201819,"Bournemouth","LADU","Total","373","32","212","98","53","768"
201819,"Bournemouth","LADU","Level 3","364","30","185","79","46","704"
201819,"Bournemouth","LADU","Level 2","6","1","15","9","3","34"
201819,"Bournemouth","LADU","All other qualifications","3","1","12","10","4","30"
201920,"Bournemouth, Christchurch and Poole","LADU","Total","1474","356","1073","516","248","3667"
201920,"Bournemouth, Christchurch and Poole","LADU","Level 3","1246","140","687","238","145","2456"
201920,"Bournemouth, Christchurch and Poole","LADU","Level 2","120","127","216","118","28","609"
201920,"Bournemouth, Christchurch and Poole","LADU","All other qualifications","108","89","170","160","75","602"
202021,"Bournemouth, Christchurch and Poole","LADU","Total","1632","255","840","441","196","3364"
202021,"Bournemouth, Christchurch and Poole","LADU","Level 3","1362","71","545","175","112","2265"
202021,"Bournemouth, Christchurch and Poole","LADU","Level 2","141","108","155","99","30","533"
202021,"Bournemouth, Christchurch and Poole","LADU","All other qualifications","129","76","140","167","54","566"
201718,"Bristol, City of","LADU","Total","1223","377","1113","434","190","3337"
201718,"Bristol, City of","LADU","Level 3","1050","163","723","205","72","2213"
201718,"Bristol, City of","LADU","Level 2","54","84","191","70","33","432"
201718,"Bristol, City of","LADU","All other qualifications","119","130","199","159","85","692"
201819,"Bristol, City of","LADU","Total","1238","343","1057","516","212","3366"
201819,"Bristol, City of","LADU","Level 3","969","139","636","187","83","2014"
201819,"Bristol, City of","LADU","Level 2","143","86","239","149","47","664"
201819,"Bristol, City of","LADU","All other qualifications","126","118","182","180","82","688"
201920,"Bristol, City of","LADU","Total","1431","322","1142","500","177","3572"
201920,"Bristol, City of","LADU","Level 3","1181","124","726","214","71","2316"
201920,"Bristol, City of","LADU","Level 2","103","95","200","95","18","511"
201920,"Bristol, City of","LADU","All other qualifications","147","103","216","191","88","745"
202021,"Bristol, City of","LADU","Total","1681","228","964","585","169","3627"
202021,"Bristol, City of","LADU","Level 3","1319","86","595","297","87","2384"
202021,"Bristol, City of","LADU","Level 2","188","70","203","109","28","598"
202021,"Bristol, City of","LADU","All other qualifications","174","72","166","179","54","645"
201718,"Cheltenham","LADU","Total","902","226","689","274","141","2232"
201718,"Cheltenham","LADU","Level 3","701","58","325","82","62","1228"
201718,"Cheltenham","LADU","Level 2","126","90","233","77","35","561"
201718,"Cheltenham","LADU","All other qualifications","75","78","131","115","44","443"
201819,"Cheltenham","LADU","Total","769","276","679","274","107","2105"
201819,"Cheltenham","LADU","Level 3","561","74","333","89","44","1101"
201819,"Cheltenham","LADU","Level 2","144","131","199","84","21","579"
201819,"Cheltenham","LADU","All other qualifications","64","71","147","101","42","425"
201920,"Cheltenham","LADU","Total","711","218","620","262","91","1902"
201920,"Cheltenham","LADU","Level 3","534","62","305","84","37","1022"
201920,"Cheltenham","LADU","Level 2","85","95","189","78","22","469"
201920,"Cheltenham","LADU","All other qualifications","92","61","126","100","32","411"
202021,"Cheltenham","LADU","Total","780","196","526","321","82","1905"
202021,"Cheltenham","LADU","Level 3","564","51","253","100","34","1002"
202021,"Cheltenham","LADU","Level 2","144","69","162","81","22","478"
202021,"Cheltenham","LADU","All other qualifications","72","76","111","140","26","425"
201718,"Christchurch","LADU","Total","158","24","114","21","15","332"
201718,"Christchurch","LADU","Level 3","157","21","106","18","14","316"
201718,"Christchurch","LADU","Level 2","1","3","5","1","0","10"
201718,"Christchurch","LADU","All other qualifications","0","0","3","2","1","6"
201819,"Christchurch","LADU","Total","156","21","105","19","19","320"
201819,"Christchurch","LADU","Level 3","156","20","97","18","19","310"
201819,"Christchurch","LADU","Level 2","0","1","2","0","0","3"
201819,"Christchurch","LADU","All other qualifications","0","0","6","1","0","7"
201718,"Cornwall","LADU","Total","2314","515","1759","909","302","5799"
201718,"Cornwall","LADU","Level 3","1820","209","1110","441","141","3721"
201718,"Cornwall","LADU","Level 2","320","197","404","209","84","1214"
201718,"Cornwall","LADU","All other qualifications","174","109","245","259","77","864"
201819,"Cornwall","LADU","Total","2130","506","1626","878","271","5411"
201819,"Cornwall","LADU","Level 3","1680","188","988","375","122","3353"
201819,"Cornwall","LADU","Level 2","294","231","449","245","70","1289"
201819,"Cornwall","LADU","All other qualifications","156","87","189","258","79","769"
201920,"Cornwall","LADU","Total","1956","482","1745","936","293","5412"
201920,"Cornwall","LADU","Level 3","1693","213","1155","453","152","3666"
201920,"Cornwall","LADU","Level 2","154","171","361","226","53","965"
201920,"Cornwall","LADU","All other qualifications","109","98","229","257","88","781"
202021,"Cornwall","LADU","Total","2417","383","1692","948","245","5685"
202021,"Cornwall","LADU","Level 3","1854","143","1168","447","123","3735"
202021,"Cornwall","LADU","Level 2","330","156","330","251","57","1124"
202021,"Cornwall","LADU","All other qualifications","233","84","194","250","65","826"
201718,"Cotswold","LADU","Total","641","121","504","118","51","1435"
201718,"Cotswold","LADU","Level 3","629","104","451","90","39","1313"
201718,"Cotswold","LADU","Level 2","11","11","30","16","6","74"
201718,"Cotswold","LADU","All other qualifications","1","6","23","12","6","48"
201819,"Cotswold","LADU","Total","688","106","455","123","45","1417"
201819,"Cotswold","LADU","Level 3","646","85","382","96","35","1244"
201819,"Cotswold","LADU","Level 2","33","10","41","12","5","101"
201819,"Cotswold","LADU","All other qualifications","9","11","32","15","5","72"
201920,"Cotswold","LADU","Total","661","94","450","140","54","1399"
201920,"Cotswold","LADU","Level 3","605","80","365","102","42","1194"
201920,"Cotswold","LADU","Level 2","37","4","43","25","3","112"
201920,"Cotswold","LADU","All other qualifications","19","10","42","13","9","93"
202021,"Cotswold","LADU","Total","754","78","455","152","58","1497"
202021,"Cotswold","LADU","Level 3","694","58","378","111","38","1279"
202021,"Cotswold","LADU","Level 2","41","6","38","17","6","108"
202021,"Cotswold","LADU","All other qualifications","19","14","39","24","14","110"
201920,"Dorset","LADU","Total","1224","230","949","363","171","2937"
201920,"Dorset","LADU","Level 3","1048","146","694","209","107","2204"
201920,"Dorset","LADU","Level 2","102","60","159","73","32","426"
201920,"Dorset","LADU","All other qualifications","74","24","96","81","32","307"
202021,"Dorset","LADU","Total","1254","167","856","371","131","2779"
202021,"Dorset","LADU","Level 3","1056","89","624","215","82","2066"
202021,"Dorset","LADU","Level 2","135","42","141","75","26","419"
202021,"Dorset","LADU","All other qualifications","63","36","91","81","23","294"
201718,"East Devon","LADU","Total","288","72","198","86","32","676"
201718,"East Devon","LADU","Level 3","286","44","171","62","23","586"
201718,"East Devon","LADU","Level 2","2","21","17","12","8","60"
201718,"East Devon","LADU","All other qualifications","0","7","10","12","1","30"
201819,"East Devon","LADU","Total","235","38","206","51","18","548"
201819,"East Devon","LADU","Level 3","226","32","175","42","14","489"
201819,"East Devon","LADU","Level 2","9","4","20","4","3","40"
201819,"East Devon","LADU","All other qualifications","0","2","11","5","1","19"
201920,"East Devon","LADU","Total","283","36","163","50","21","553"
201920,"East Devon","LADU","Level 3","274","26","149","39","18","506"
201920,"East Devon","LADU","Level 2","5","4","9","10","0","28"
201920,"East Devon","LADU","All other qualifications","4","6","5","1","3","19"
202021,"East Devon","LADU","Total","252","27","129","58","17","483"
202021,"East Devon","LADU","Level 3","245","17","109","50","13","434"
202021,"East Devon","LADU","Level 2","2","3","10","5","4","24"
202021,"East Devon","LADU","All other qualifications","5","7","10","3","0","25"
201718,"East Dorset","LADU","Total","142","33","112","29","20","336"
201718,"East Dorset","LADU","Level 3","138","27","109","25","15","314"
201718,"East Dorset","LADU","Level 2","4","4","2","4","1","15"
201718,"East Dorset","LADU","All other qualifications","0","2","1","0","4","7"
201819,"East Dorset","LADU","Total","129","30","91","24","18","292"
201819,"East Dorset","LADU","Level 3","124","27","84","17","15","267"
201819,"East Dorset","LADU","Level 2","5","1","5","4","3","18"
201819,"East Dorset","LADU","All other qualifications","0","2","2","3","0","7"
201718,"Exeter","LADU","Total","1031","332","937","325","125","2750"
201718,"Exeter","LADU","Level 3","897","161","665","176","67","1966"
201718,"Exeter","LADU","Level 2","91","106","185","58","26","466"
201718,"Exeter","LADU","All other qualifications","43","65","87","91","32","318"
201819,"Exeter","LADU","Total","800","327","978","355","122","2582"
201819,"Exeter","LADU","Level 3","701","140","606","161","60","1668"
201819,"Exeter","LADU","Level 2","73","127","272","90","18","580"
201819,"Exeter","LADU","All other qualifications","26","60","100","104","44","334"
201920,"Exeter","LADU","Total","932","350","1029","400","147","2858"
201920,"Exeter","LADU","Level 3","862","151","740","214","75","2042"
201920,"Exeter","LADU","Level 2","34","125","186","81","15","441"
201920,"Exeter","LADU","All other qualifications","36","74","103","105","57","375"
202021,"Exeter","LADU","Total","1541","275","985","444","135","3380"
202021,"Exeter","LADU","Level 3","1294","133","715","242","82","2466"
202021,"Exeter","LADU","Level 2","192","85","169","85","16","547"
202021,"Exeter","LADU","All other qualifications","55","57","101","117","37","367"
201718,"Forest of Dean","LADU","Total","397","77","299","99","72","944"
201718,"Forest of Dean","LADU","Level 3","360","61","237","78","52","788"
201718,"Forest of Dean","LADU","Level 2","13","6","31","10","11","71"
201718,"Forest of Dean","LADU","All other qualifications","24","10","31","11","9","85"
201819,"Forest of Dean","LADU","Total","463","82","349","98","67","1059"
201819,"Forest of Dean","LADU","Level 3","385","58","290","82","49","864"
201819,"Forest of Dean","LADU","Level 2","35","7","33","10","8","93"
201819,"Forest of Dean","LADU","All other qualifications","43","17","26","6","10","102"
201920,"Forest of Dean","LADU","Total","453","65","335","113","73","1039"
201920,"Forest of Dean","LADU","Level 3","397","52","292","89","58","888"
201920,"Forest of Dean","LADU","Level 2","4","5","20","8","11","48"
201920,"Forest of Dean","LADU","All other qualifications","52","8","23","16","4","103"
202021,"Forest of Dean","LADU","Total","483","69","333","128","58","1071"
202021,"Forest of Dean","LADU","Level 3","412","47","287","105","48","899"
202021,"Forest of Dean","LADU","Level 2","36","13","24","10","5","88"
202021,"Forest of Dean","LADU","All other qualifications","35","9","22","13","5","84"
201718,"Gloucester","LADU","Total","507","55","193","55","30","840"
201718,"Gloucester","LADU","Level 3","505","51","183","51","29","819"
201718,"Gloucester","LADU","Level 2","2","2","8","2","1","15"
201718,"Gloucester","LADU","All other qualifications","0","2","2","2","0","6"
201819,"Gloucester","LADU","Total","473","73","189","48","32","815"
201819,"Gloucester","LADU","Level 3","471","61","179","41","30","782"
201819,"Gloucester","LADU","Level 2","1","5","5","5","0","16"
201819,"Gloucester","LADU","All other qualifications","1","7","5","2","2","17"
201920,"Gloucester","LADU","Total","461","82","193","61","25","822"
201920,"Gloucester","LADU","Level 3","456","68","182","45","23","774"
201920,"Gloucester","LADU","Level 2","2","4","4","5","0","15"
201920,"Gloucester","LADU","All other qualifications","3","10","7","11","2","33"
202021,"Gloucester","LADU","Total","467","59","169","60","37","792"
202021,"Gloucester","LADU","Level 3","457","46","151","49","36","739"
202021,"Gloucester","LADU","Level 2","2","1","4","2","0","9"
202021,"Gloucester","LADU","All other qualifications","8","12","14","9","1","44"
201718,"Mendip","LADU","Total","434","65","339","94","39","971"
201718,"Mendip","LADU","Level 3","415","37","253","54","17","776"
201718,"Mendip","LADU","Level 2","16","16","57","22","11","122"
201718,"Mendip","LADU","All other qualifications","3","12","29","18","11","73"
201819,"Mendip","LADU","Total","568","68","380","90","46","1152"
201819,"Mendip","LADU","Level 3","517","42","278","42","21","900"
201819,"Mendip","LADU","Level 2","42","22","75","28","12","179"
201819,"Mendip","LADU","All other qualifications","9","4","27","20","13","73"
201920,"Mendip","LADU","Total","374","66","309","103","44","896"
201920,"Mendip","LADU","Level 3","359","42","225","62","20","708"
201920,"Mendip","LADU","Level 2","7","11","45","19","9","91"
201920,"Mendip","LADU","All other qualifications","8","13","39","22","15","97"
202021,"Mendip","LADU","Total","486","54","328","133","46","1047"
202021,"Mendip","LADU","Level 3","385","28","255","84","30","782"
202021,"Mendip","LADU","Level 2","66","18","45","23","9","161"
202021,"Mendip","LADU","All other qualifications","35","8","28","26","7","104"
201718,"Mid Devon","LADU","Total","54","4","31","4","12","105"
201718,"Mid Devon","LADU","Level 3","53","3","28","2","12","98"
201718,"Mid Devon","LADU","Level 2","1","1","2","2","0","6"
201718,"Mid Devon","LADU","All other qualifications","0","0","1","0","0","1"
201819,"Mid Devon","LADU","Total","45","7","48","11","11","122"
201819,"Mid Devon","LADU","Level 3","45","4","45","10","11","115"
201819,"Mid Devon","LADU","Level 2","0","2","2","1","0","5"
201819,"Mid Devon","LADU","All other qualifications","0","1","1","0","0","2"
201920,"Mid Devon","LADU","Total","25","4","31","3","8","71"
201920,"Mid Devon","LADU","Level 3","24","3","30","2","7","66"
201920,"Mid Devon","LADU","Level 2","0","0","1","0","1","2"
201920,"Mid Devon","LADU","All other qualifications","1","1","0","1","0","3"
202021,"Mid Devon","LADU","Total","47","4","23","9","10","93"
202021,"Mid Devon","LADU","Level 3","47","1","20","8","6","82"
202021,"Mid Devon","LADU","Level 2","0","0","1","0","4","5"
202021,"Mid Devon","LADU","All other qualifications","0","3","2","1","0","6"
201718,"North Devon","LADU","Total","570","184","413","226","70","1463"
201718,"North Devon","LADU","Level 3","413","62","202","59","18","754"
201718,"North Devon","LADU","Level 2","88","69","126","60","17","360"
201718,"North Devon","LADU","All other qualifications","69","53","85","107","35","349"
201819,"North Devon","LADU","Total","521","164","478","251","54","1468"
201819,"North Devon","LADU","Level 3","334","52","207","60","17","670"
201819,"North Devon","LADU","Level 2","116","69","157","70","13","425"
201819,"North Devon","LADU","All other qualifications","71","43","114","121","24","373"
201920,"North Devon","LADU","Total","470","113","421","244","57","1305"
201920,"North Devon","LADU","Level 3","328","30","211","78","19","666"
201920,"North Devon","LADU","Level 2","68","48","117","60","11","304"
201920,"North Devon","LADU","All other qualifications","74","35","93","106","27","335"
202021,"North Devon","LADU","Total","533","106","333","267","66","1305"
202021,"North Devon","LADU","Level 3","347","23","155","59","10","594"
202021,"North Devon","LADU","Level 2","114","41","98","87","18","358"
202021,"North Devon","LADU","All other qualifications","72","42","80","121","38","353"
201718,"North Dorset","LADU","Total","220","39","125","37","22","443"
201718,"North Dorset","LADU","Level 3","212","35","118","30","19","414"
201718,"North Dorset","LADU","Level 2","8","3","7","6","1","25"
201718,"North Dorset","LADU","All other qualifications","0","1","0","1","2","4"
201819,"North Dorset","LADU","Total","175","27","122","25","15","364"
201819,"North Dorset","LADU","Level 3","174","23","110","21","11","339"
201819,"North Dorset","LADU","Level 2","0","3","10","3","3","19"
201819,"North Dorset","LADU","All other qualifications","1","1","2","1","1","6"
201718,"North Somerset","LADU","Total","945","277","702","387","145","2456"
201718,"North Somerset","LADU","Level 3","775","105","426","132","45","1483"
201718,"North Somerset","LADU","Level 2","125","54","151","79","23","432"
201718,"North Somerset","LADU","All other qualifications","45","118","125","176","77","541"
201819,"North Somerset","LADU","Total","956","311","686","367","123","2443"
201819,"North Somerset","LADU","Level 3","686","110","389","77","42","1304"
201819,"North Somerset","LADU","Level 2","201","83","177","102","23","586"
201819,"North Somerset","LADU","All other qualifications","69","118","120","188","58","553"
201920,"North Somerset","LADU","Total","901","254","690","373","115","2333"
201920,"North Somerset","LADU","Level 3","703","90","418","97","47","1355"
201920,"North Somerset","LADU","Level 2","133","88","137","76","22","456"
201920,"North Somerset","LADU","All other qualifications","65","76","135","200","46","522"
202021,"North Somerset","LADU","Total","947","199","657","394","90","2287"
202021,"North Somerset","LADU","Level 3","711","45","413","127","34","1330"
202021,"North Somerset","LADU","Level 2","153","95","130","85","27","490"
202021,"North Somerset","LADU","All other qualifications","83","59","114","182","29","467"
201718,"Plymouth","LADU","Total","1060","424","666","382","157","2689"
201718,"Plymouth","LADU","Level 3","898","220","417","144","57","1736"
201718,"Plymouth","LADU","Level 2","105","135","178","118","57","593"
201718,"Plymouth","LADU","All other qualifications","57","69","71","120","43","360"
201819,"Plymouth","LADU","Total","1126","428","588","399","112","2653"
201819,"Plymouth","LADU","Level 3","897","146","355","132","42","1572"
201819,"Plymouth","LADU","Level 2","156","206","178","154","37","731"
201819,"Plymouth","LADU","All other qualifications","73","76","55","113","33","350"
201920,"Plymouth","LADU","Total","1037","416","652","405","106","2616"
201920,"Plymouth","LADU","Level 3","843","177","421","151","48","1640"
201920,"Plymouth","LADU","Level 2","130","163","153","122","22","590"
201920,"Plymouth","LADU","All other qualifications","64","76","78","132","36","386"
202021,"Plymouth","LADU","Total","1166","294","588","406","95","2549"
202021,"Plymouth","LADU","Level 3","914","109","388","168","37","1616"
202021,"Plymouth","LADU","Level 2","159","103","136","122","18","538"
202021,"Plymouth","LADU","All other qualifications","93","82","64","116","40","395"
201718,"Poole","LADU","Total","793","363","883","388","216","2643"
201718,"Poole","LADU","Level 3","687","92","448","145","96","1468"
201718,"Poole","LADU","Level 2","52","165","258","81","53","609"
201718,"Poole","LADU","All other qualifications","54","106","177","162","67","566"
201819,"Poole","LADU","Total","874","277","820","401","180","2552"
201819,"Poole","LADU","Level 3","640","67","372","115","81","1275"
201819,"Poole","LADU","Level 2","136","145","270","130","35","716"
201819,"Poole","LADU","All other qualifications","98","65","178","156","64","561"
201718,"Purbeck","LADU","Total","106","13","58","21","11","209"
201718,"Purbeck","LADU","Level 3","106","13","50","20","7","196"
201718,"Purbeck","LADU","Level 2","0","0","5","1","1","7"
201718,"Purbeck","LADU","All other qualifications","0","0","3","0","3","6"
201819,"Purbeck","LADU","Total","105","22","62","16","8","213"
201819,"Purbeck","LADU","Level 3","102","20","52","12","5","191"
201819,"Purbeck","LADU","Level 2","3","1","7","3","2","16"
201819,"Purbeck","LADU","All other qualifications","0","1","3","1","1","6"
201718,"Sedgemoor","LADU","Total","551","226","566","225","112","1680"
201718,"Sedgemoor","LADU","Level 3","434","99","337","79","54","1003"
201718,"Sedgemoor","LADU","Level 2","54","71","134","61","21","341"
201718,"Sedgemoor","LADU","All other qualifications","63","56","95","85","37","336"
201819,"Sedgemoor","LADU","Total","762","349","827","377","133","2448"
201819,"Sedgemoor","LADU","Level 3","455","107","385","109","42","1098"
201819,"Sedgemoor","LADU","Level 2","217","171","336","144","53","921"
201819,"Sedgemoor","LADU","All other qualifications","90","71","106","124","38","429"
201920,"Sedgemoor","LADU","Total","700","280","657","329","141","2107"
201920,"Sedgemoor","LADU","Level 3","461","124","329","75","39","1028"
201920,"Sedgemoor","LADU","Level 2","142","84","212","106","39","583"
201920,"Sedgemoor","LADU","All other qualifications","97","72","116","148","63","496"
202021,"Sedgemoor","LADU","Total","671","242","608","359","91","1971"
202021,"Sedgemoor","LADU","Level 3","411","88","308","85","43","935"
202021,"Sedgemoor","LADU","Level 2","150","77","162","126","26","541"
202021,"Sedgemoor","LADU","All other qualifications","110","77","138","148","22","495"
201920,"Somerset West and Taunton","LADU","Total","431","90","342","104","45","1012"
201920,"Somerset West and Taunton","LADU","Level 3","397","61","284","81","36","859"
201920,"Somerset West and Taunton","LADU","Level 2","18","14","30","6","4","72"
201920,"Somerset West and Taunton","LADU","All other qualifications","16","15","28","17","5","81"
202021,"Somerset West and Taunton","LADU","Total","465","74","358","111","53","1061"
202021,"Somerset West and Taunton","LADU","Level 3","431","43","303","76","40","893"
202021,"Somerset West and Taunton","LADU","Level 2","16","11","24","12","3","66"
202021,"Somerset West and Taunton","LADU","All other qualifications","18","20","31","23","10","102"
201718,"South Gloucestershire","LADU","Total","1224","402","1009","332","135","3102"
201718,"South Gloucestershire","LADU","Level 3","1028","221","639","151","55","2094"
201718,"South Gloucestershire","LADU","Level 2","129","97","215","84","33","558"
201718,"South Gloucestershire","LADU","All other qualifications","67","84","155","97","47","450"
201819,"South Gloucestershire","LADU","Total","1203","372","980","362","185","3102"
201819,"South Gloucestershire","LADU","Level 3","908","203","580","136","100","1927"
201819,"South Gloucestershire","LADU","Level 2","201","106","246","96","40","689"
201819,"South Gloucestershire","LADU","All other qualifications","94","63","154","130","45","486"
201920,"South Gloucestershire","LADU","Total","1063","316","934","358","153","2824"
201920,"South Gloucestershire","LADU","Level 3","844","153","578","134","72","1781"
201920,"South Gloucestershire","LADU","Level 2","131","83","201","99","40","554"
201920,"South Gloucestershire","LADU","All other qualifications","88","80","155","125","41","489"
202021,"South Gloucestershire","LADU","Total","1168","264","851","451","143","2877"
202021,"South Gloucestershire","LADU","Level 3","926","122","514","179","79","1820"
202021,"South Gloucestershire","LADU","Level 2","157","68","188","105","23","541"
202021,"South Gloucestershire","LADU","All other qualifications","85","74","149","167","41","516"
201718,"South Hams","LADU","Total","192","34","198","48","19","491"
201718,"South Hams","LADU","Level 3","192","31","186","46","16","471"
201718,"South Hams","LADU","Level 2","0","0","8","0","1","9"
201718,"South Hams","LADU","All other qualifications","0","3","4","2","2","11"
201819,"South Hams","LADU","Total","243","42","172","32","15","504"
201819,"South Hams","LADU","Level 3","240","39","163","28","14","484"
201819,"South Hams","LADU","Level 2","2","2","5","3","1","13"
201819,"South Hams","LADU","All other qualifications","1","1","4","1","0","7"
201920,"South Hams","LADU","Total","216","29","119","60","17","441"
201920,"South Hams","LADU","Level 3","212","27","111","53","16","419"
201920,"South Hams","LADU","Level 2","0","2","1","1","0","4"
201920,"South Hams","LADU","All other qualifications","4","0","7","6","1","18"
202021,"South Hams","LADU","Total","195","23","121","46","11","396"
202021,"South Hams","LADU","Level 3","188","20","119","42","8","377"
202021,"South Hams","LADU","Level 2","3","1","0","0","0","4"
202021,"South Hams","LADU","All other qualifications","4","2","2","4","3","15"
201718,"South Somerset","LADU","Total","334","171","411","148","55","1119"
201718,"South Somerset","LADU","Level 3","284","59","260","50","18","671"
201718,"South Somerset","LADU","Level 2","34","84","98","43","16","275"
201718,"South Somerset","LADU","All other qualifications","16","28","53","55","21","173"
201819,"South Somerset","LADU","Total","290","136","358","143","54","981"
201819,"South Somerset","LADU","Level 3","250","45","167","28","20","510"
201819,"South Somerset","LADU","Level 2","28","64","140","60","22","314"
201819,"South Somerset","LADU","All other qualifications","12","27","51","55","12","157"
201920,"South Somerset","LADU","Total","243","195","403","166","76","1083"
201920,"South Somerset","LADU","Level 3","214","78","219","52","38","601"
201920,"South Somerset","LADU","Level 2","17","77","120","58","13","285"
201920,"South Somerset","LADU","All other qualifications","12","40","64","56","25","197"
202021,"South Somerset","LADU","Total","332","157","341","174","52","1056"
202021,"South Somerset","LADU","Level 3","237","56","200","67","30","590"
202021,"South Somerset","LADU","Level 2","67","72","93","52","8","292"
202021,"South Somerset","LADU","All other qualifications","28","29","48","55","14","174"
201718,"Stroud","LADU","Total","333","25","144","35","15","552"
201718,"Stroud","LADU","Level 3","333","22","139","35","13","542"
201718,"Stroud","LADU","Level 2","0","3","3","0","0","6"
201718,"Stroud","LADU","All other qualifications","0","0","2","0","2","4"
201819,"Stroud","LADU","Total","336","39","167","40","12","594"
201819,"Stroud","LADU","Level 3","336","38","165","40","11","590"
201819,"Stroud","LADU","Level 2","0","0","1","0","1","2"
201819,"Stroud","LADU","All other qualifications","0","1","1","0","0","2"
201920,"Stroud","LADU","Total","317","44","159","45","20","585"
201920,"Stroud","LADU","Level 3","315","42","157","44","20","578"
201920,"Stroud","LADU","All other qualifications","2","2","2","1","0","7"
202021,"Stroud","LADU","Total","272","27","154","51","19","523"
202021,"Stroud","LADU","Level 3","271","26","152","48","19","516"
202021,"Stroud","LADU","Level 2","0","0","1","0","0","1"
202021,"Stroud","LADU","All other qualifications","1","1","1","3","0","6"
201718,"Swindon","LADU","Total","918","327","1049","370","174","2838"
201718,"Swindon","LADU","Level 3","699","151","585","119","70","1624"
201718,"Swindon","LADU","Level 2","127","96","229","82","25","559"
201718,"Swindon","LADU","All other qualifications","92","80","235","169","79","655"
201819,"Swindon","LADU","Total","884","346","923","390","109","2652"
201819,"Swindon","LADU","Level 3","645","126","463","142","37","1413"
201819,"Swindon","LADU","Level 2","139","109","248","78","26","600"
201819,"Swindon","LADU","All other qualifications","100","111","212","170","46","639"
201920,"Swindon","LADU","Total","861","244","835","377","113","2430"
201920,"Swindon","LADU","Level 3","633","102","459","126","39","1359"
201920,"Swindon","LADU","Level 2","157","73","191","109","16","546"
201920,"Swindon","LADU","All other qualifications","71","69","185","142","58","525"
202021,"Swindon","LADU","Total","1177","158","713","449","106","2603"
202021,"Swindon","LADU","Level 3","802","56","388","188","46","1480"
202021,"Swindon","LADU","Level 2","278","50","192","130","21","671"
202021,"Swindon","LADU","All other qualifications","97","52","133","131","39","452"
201718,"Taunton Deane","LADU","Total","521","111","354","142","45","1173"
201718,"Taunton Deane","LADU","Level 3","501","61","284","91","27","964"
201718,"Taunton Deane","LADU","Level 2","9","24","33","14","5","85"
201718,"Taunton Deane","LADU","All other qualifications","11","26","37","37","13","124"
201819,"Taunton Deane","LADU","Total","409","99","323","102","48","981"
201819,"Taunton Deane","LADU","Level 3","376","63","262","76","34","811"
201819,"Taunton Deane","LADU","Level 2","13","18","24","8","4","67"
201819,"Taunton Deane","LADU","All other qualifications","20","18","37","18","10","103"
201718,"Teignbridge","LADU","Total","227","55","119","52","11","464"
201718,"Teignbridge","LADU","Level 3","219","41","105","29","8","402"
201718,"Teignbridge","LADU","Level 2","8","8","10","17","1","44"
201718,"Teignbridge","LADU","All other qualifications","0","6","4","6","2","18"
201819,"Teignbridge","LADU","Total","202","63","174","50","29","518"
201819,"Teignbridge","LADU","Level 3","194","45","146","33","22","440"
201819,"Teignbridge","LADU","Level 2","6","11","20","12","4","53"
201819,"Teignbridge","LADU","All other qualifications","2","7","8","5","3","25"
201920,"Teignbridge","LADU","Total","164","44","126","53","23","410"
201920,"Teignbridge","LADU","Level 3","160","32","96","44","19","351"
201920,"Teignbridge","LADU","Level 2","3","5","15","4","3","30"
201920,"Teignbridge","LADU","All other qualifications","1","7","15","5","1","29"
202021,"Teignbridge","LADU","Total","166","26","112","46","35","385"
202021,"Teignbridge","LADU","Level 3","156","17","98","29","31","331"
202021,"Teignbridge","LADU","Level 2","6","3","8","11","2","30"
202021,"Teignbridge","LADU","All other qualifications","4","6","6","6","2","24"
201718,"Tewkesbury","LADU","Total","229","60","151","30","21","491"
201718,"Tewkesbury","LADU","Level 3","228","57","143","26","17","471"
201718,"Tewkesbury","LADU","Level 2","1","1","7","1","2","12"
201718,"Tewkesbury","LADU","All other qualifications","0","2","1","3","2","8"
201819,"Tewkesbury","LADU","Total","229","53","134","32","13","461"
201819,"Tewkesbury","LADU","Level 3","229","51","128","26","12","446"
201819,"Tewkesbury","LADU","Level 2","0","1","5","3","0","9"
201819,"Tewkesbury","LADU","All other qualifications","0","1","1","3","1","6"
201920,"Tewkesbury","LADU","Total","208","47","139","40","17","451"
201920,"Tewkesbury","LADU","Level 3","204","44","134","37","15","434"
201920,"Tewkesbury","LADU","Level 2","2","1","3","1","1","8"
201920,"Tewkesbury","LADU","All other qualifications","2","2","2","2","1","9"
202021,"Tewkesbury","LADU","Total","236","28","116","51","16","447"
202021,"Tewkesbury","LADU","Level 3","224","24","103","48","16","415"
202021,"Tewkesbury","LADU","Level 2","6","1","3","0","0","10"
202021,"Tewkesbury","LADU","All other qualifications","6","3","10","3","0","22"
201718,"Torbay","LADU","Total","747","166","609","336","124","1982"
201718,"Torbay","LADU","Level 3","555","58","331","122","60","1126"
201718,"Torbay","LADU","Level 2","117","63","174","81","24","459"
201718,"Torbay","LADU","All other qualifications","75","45","104","133","40","397"
201819,"Torbay","LADU","Total","765","180","555","279","99","1878"
201819,"Torbay","LADU","Level 3","557","52","306","96","52","1063"
201819,"Torbay","LADU","Level 2","158","78","158","85","22","501"
201819,"Torbay","LADU","All other qualifications","50","50","91","98","25","314"
201920,"Torbay","LADU","Total","625","152","425","276","109","1587"
201920,"Torbay","LADU","Level 3","510","54","219","90","65","938"
201920,"Torbay","LADU","Level 2","72","54","116","77","22","341"
201920,"Torbay","LADU","All other qualifications","43","44","90","109","22","308"
202021,"Torbay","LADU","Total","749","169","452","297","124","1791"
202021,"Torbay","LADU","Level 3","549","41","254","113","75","1032"
202021,"Torbay","LADU","Level 2","150","75","109","100","24","458"
202021,"Torbay","LADU","All other qualifications","50","53","89","84","25","301"
201718,"Torridge","LADU","Total","43","5","24","9","3","84"
201718,"Torridge","LADU","Level 3","43","4","24","8","2","81"
201718,"Torridge","LADU","Level 2","0","1","0","1","1","3"
201819,"Torridge","LADU","Total","38","3","34","10","4","89"
201819,"Torridge","LADU","Level 3","38","3","31","9","4","85"
201819,"Torridge","LADU","Level 2","0","0","1","0","0","1"
201819,"Torridge","LADU","All other qualifications","0","0","2","1","0","3"
201920,"Torridge","LADU","Total","38","3","25","12","3","81"
201920,"Torridge","LADU","Level 3","38","3","25","12","1","79"
201920,"Torridge","LADU","All other qualifications","0","0","0","0","2","2"
202021,"Torridge","LADU","Total","28","1","17","7","1","54"
202021,"Torridge","LADU","Level 3","28","1","17","6","1","53"
202021,"Torridge","LADU","All other qualifications","0","0","0","1","0","1"
201718,"West Devon","LADU","Total","103","21","69","18","7","218"
201718,"West Devon","LADU","Level 3","101","16","64","13","4","198"
201718,"West Devon","LADU","Level 2","1","5","3","5","1","15"
201718,"West Devon","LADU","All other qualifications","1","0","2","0","2","5"
201819,"West Devon","LADU","Total","89","17","67","27","8","208"
201819,"West Devon","LADU","Level 3","88","13","61","22","7","191"
201819,"West Devon","LADU","Level 2","1","1","4","5","1","12"
201819,"West Devon","LADU","All other qualifications","0","3","2","0","0","5"
201920,"West Devon","LADU","Total","105","18","67","21","14","225"
201920,"West Devon","LADU","Level 3","103","10","56","19","11","199"
201920,"West Devon","LADU","Level 2","2","3","3","2","2","12"
201920,"West Devon","LADU","All other qualifications","0","5","8","0","1","14"
202021,"West Devon","LADU","Total","91","16","60","21","6","194"
202021,"West Devon","LADU","Level 3","89","10","47","17","5","168"
202021,"West Devon","LADU","Level 2","1","1","8","3","1","14"
202021,"West Devon","LADU","All other qualifications","1","5","5","1","0","12"
201718,"West Dorset","LADU","Total","540","110","445","138","62","1295"
201718,"West Dorset","LADU","Level 3","511","57","338","85","39","1030"
201718,"West Dorset","LADU","Level 2","14","41","81","34","14","184"
201718,"West Dorset","LADU","All other qualifications","15","12","26","19","9","81"
201819,"West Dorset","LADU","Total","540","97","443","129","64","1273"
201819,"West Dorset","LADU","Level 3","476","53","341","76","45","991"
201819,"West Dorset","LADU","Level 2","45","33","84","33","14","209"
201819,"West Dorset","LADU","All other qualifications","19","11","18","20","5","73"
201718,"West Somerset","LADU","Total","15","10","52","25","12","114"
201718,"West Somerset","LADU","Level 3","15","7","24","13","3","62"
201718,"West Somerset","LADU","Level 2","0","2","19","9","5","35"
201718,"West Somerset","LADU","All other qualifications","0","1","9","3","4","17"
201819,"West Somerset","LADU","Total","15","5","30","10","4","64"
201819,"West Somerset","LADU","Level 3","15","4","19","6","1","45"
201819,"West Somerset","LADU","Level 2","0","0","8","4","2","14"
201819,"West Somerset","LADU","All other qualifications","0","1","3","0","1","5"
201718,"Weymouth and Portland","LADU","Total","139","54","238","118","43","592"
201718,"Weymouth and Portland","LADU","Level 3","108","14","134","37","20","313"
201718,"Weymouth and Portland","LADU","Level 2","21","28","62","35","6","152"
201718,"Weymouth and Portland","LADU","All other qualifications","10","12","42","46","17","127"
201819,"Weymouth and Portland","LADU","Total","146","71","251","111","38","617"
201819,"Weymouth and Portland","LADU","Level 3","88","17","88","20","15","228"
201819,"Weymouth and Portland","LADU","Level 2","50","46","131","60","13","300"
201819,"Weymouth and Portland","LADU","All other qualifications","8","8","32","31","10","89"
201718,"Wiltshire","LADU","Total","1722","328","1273","433","169","3925"
201718,"Wiltshire","LADU","Level 3","1495","173","841","235","71","2815"
201718,"Wiltshire","LADU","Level 2","140","88","237","68","30","563"
201718,"Wiltshire","LADU","All other qualifications","87","67","195","130","68","547"
201819,"Wiltshire","LADU","Total","1614","308","1254","420","153","3749"
201819,"Wiltshire","LADU","Level 3","1323","142","832","186","67","2550"
201819,"Wiltshire","LADU","Level 2","189","99","242","95","39","664"
201819,"Wiltshire","LADU","All other qualifications","102","67","180","139","47","535"
201920,"Wiltshire","LADU","Total","1642","242","1228","458","186","3756"
201920,"Wiltshire","LADU","Level 3","1391","116","797","216","88","2608"
201920,"Wiltshire","LADU","Level 2","134","60","221","95","36","546"
201920,"Wiltshire","LADU","All other qualifications","117","66","210","147","62","602"
202021,"Wiltshire","LADU","Total","1738","244","1101","475","200","3758"
202021,"Wiltshire","LADU","Level 3","1488","90","727","211","102","2618"
202021,"Wiltshire","LADU","Level 2","135","58","186","100","29","508"
202021,"Wiltshire","LADU","All other qualifications","115","96","188","164","69","632"
201718,"Black Country","LEP","All other qualifications","419","345","425","605","296","2090"
201718,"Black Country","LEP","Level 2","563","373","574","418","151","2079"
201718,"Black Country","LEP","Level 3","5206","674","1502","787","380","8549"
201718,"Black Country","LEP","Total","6188","1392","2501","1810","827","12718"
201819,"Black Country","LEP","All other qualifications","418","280","386","654","300","2038"
201819,"Black Country","LEP","Level 2","992","406","821","628","200","3047"
201819,"Black Country","LEP","Level 3","5124","717","1303","756","302","8202"
201819,"Black Country","LEP","Total","6534","1403","2510","2038","802","13287"
201920,"Black Country","LEP","All other qualifications","537","246","447","725","343","2298"
201920,"Black Country","LEP","Level 2","815","350","527","537","123","2352"
201920,"Black Country","LEP","Level 3","5643","596","1514","939","330","9022"
201920,"Black Country","LEP","Total","6995","1192","2488","2201","796","13672"
202021,"Black Country","LEP","All other qualifications","715","268","443","847","258","2531"
202021,"Black Country","LEP","Level 2","1313","309","509","635","113","2879"
202021,"Black Country","LEP","Level 3","6223","412","1390","1230","335","9590"
202021,"Black Country","LEP","Total","8251","989","2342","2712","706","15000"
201718,"Buckinghamshire","LEP","All other qualifications","40","75","148","85","55","403"
201718,"Buckinghamshire","LEP","Level 2","69","71","169","69","26","404"
201718,"Buckinghamshire","LEP","Level 3","2732","149","929","299","134","4243"
201718,"Buckinghamshire","LEP","Total","2841","295","1246","453","215","5050"
201819,"Buckinghamshire","LEP","All other qualifications","56","49","140","112","47","404"
201819,"Buckinghamshire","LEP","Level 2","183","79","208","100","28","598"
201819,"Buckinghamshire","LEP","Level 3","2490","146","867","246","141","3890"
201819,"Buckinghamshire","LEP","Total","2729","274","1215","458","216","4892"
201920,"Buckinghamshire","LEP","All other qualifications","53","43","142","118","61","417"
201920,"Buckinghamshire","LEP","Level 2","64","60","130","42","18","314"
201920,"Buckinghamshire","LEP","Level 3","2541","153","843","234","125","3896"
201920,"Buckinghamshire","LEP","Total","2658","256","1115","394","204","4627"
202021,"Buckinghamshire","LEP","All other qualifications","83","59","133","144","57","476"
202021,"Buckinghamshire","LEP","Level 2","121","61","147","100","36","465"
202021,"Buckinghamshire","LEP","Level 3","2630","117","769","292","154","3962"
202021,"Buckinghamshire","LEP","Total","2834","237","1049","536","247","4903"
201718,"Cheshire and Warrington","LEP","All other qualifications","173","214","321","312","107","1127"
201718,"Cheshire and Warrington","LEP","Level 2","285","223","460","198","96","1262"
201718,"Cheshire and Warrington","LEP","Level 3","4126","621","1949","536","243","7475"
201718,"Cheshire and Warrington","LEP","Total","4584","1058","2730","1046","446","9864"
201819,"Cheshire and Warrington","LEP","All other qualifications","136","201","295","276","95","1003"
201819,"Cheshire and Warrington","LEP","Level 2","431","284","669","309","110","1803"
201819,"Cheshire and Warrington","LEP","Level 3","3860","624","1701","507","192","6884"
201819,"Cheshire and Warrington","LEP","Total","4427","1109","2665","1092","397","9690"
201920,"Cheshire and Warrington","LEP","All other qualifications","152","217","287","324","102","1082"
201920,"Cheshire and Warrington","LEP","Level 2","238","196","455","243","69","1201"
201920,"Cheshire and Warrington","LEP","Level 3","3884","550","1813","521","237","7005"
201920,"Cheshire and Warrington","LEP","Total","4274","963","2555","1088","408","9288"
202021,"Cheshire and Warrington","LEP","All other qualifications","289","180","272","343","91","1175"
202021,"Cheshire and Warrington","LEP","Level 2","495","175","404","276","65","1415"
202021,"Cheshire and Warrington","LEP","Level 3","4234","366","1617","666","222","7105"
202021,"Cheshire and Warrington","LEP","Total","5018","721","2293","1285","378","9695"
201718,"Coast to Capital","LEP","All other qualifications","324","193","531","507","284","1839"
201718,"Coast to Capital","LEP","Level 2","488","313","774","358","189","2122"
201718,"Coast to Capital","LEP","Level 3","5710","580","3305","895","475","10965"
201718,"Coast to Capital","LEP","Total","6522","1086","4610","1760","948","14926"
201819,"Coast to Capital","LEP","All other qualifications","390","228","570","551","289","2028"
201819,"Coast to Capital","LEP","Level 2","925","344","1014","432","228","2943"
201819,"Coast to Capital","LEP","Level 3","5507","530","3285","819","490","10631"
201819,"Coast to Capital","LEP","Total","6822","1102","4869","1802","1007","15602"
201920,"Coast to Capital","LEP","All other qualifications","410","297","616","558","283","2164"
201920,"Coast to Capital","LEP","Level 2","614","288","739","381","169","2191"
201920,"Coast to Capital","LEP","Level 3","5596","473","3281","885","493","10728"
201920,"Coast to Capital","LEP","Total","6620","1058","4636","1824","945","15083"
202021,"Coast to Capital","LEP","All other qualifications","570","232","538","558","241","2139"
202021,"Coast to Capital","LEP","Level 2","841","197","620","442","153","2253"
202021,"Coast to Capital","LEP","Level 3","5947","312","2713","1085","556","10613"
202021,"Coast to Capital","LEP","Total","7358","741","3871","2085","950","15005"
201718,"Cornwall and Isles of Scilly","LEP","All other qualifications","174","109","245","259","77","864"
201718,"Cornwall and Isles of Scilly","LEP","Level 2","320","197","404","209","84","1214"
201718,"Cornwall and Isles of Scilly","LEP","Level 3","1820","209","1110","441","141","3721"
201718,"Cornwall and Isles of Scilly","LEP","Total","2314","515","1759","909","302","5799"
201819,"Cornwall and Isles of Scilly","LEP","All other qualifications","156","87","189","258","79","769"
201819,"Cornwall and Isles of Scilly","LEP","Level 2","294","231","449","245","70","1289"
201819,"Cornwall and Isles of Scilly","LEP","Level 3","1680","188","988","375","122","3353"
201819,"Cornwall and Isles of Scilly","LEP","Total","2130","506","1626","878","271","5411"
201920,"Cornwall and Isles of Scilly","LEP","All other qualifications","109","98","229","257","88","781"
201920,"Cornwall and Isles of Scilly","LEP","Level 2","154","171","361","226","53","965"
201920,"Cornwall and Isles of Scilly","LEP","Level 3","1693","213","1155","453","152","3666"
201920,"Cornwall and Isles of Scilly","LEP","Total","1956","482","1745","936","293","5412"
202021,"Cornwall and Isles of Scilly","LEP","All other qualifications","233","84","194","250","65","826"
202021,"Cornwall and Isles of Scilly","LEP","Level 2","330","156","330","251","57","1124"
202021,"Cornwall and Isles of Scilly","LEP","Level 3","1854","143","1168","447","123","3735"
202021,"Cornwall and Isles of Scilly","LEP","Total","2417","383","1692","948","245","5685"
201718,"Coventry and Warwickshire","LEP","All other qualifications","229","219","442","393","181","1464"
201718,"Coventry and Warwickshire","LEP","Level 2","439","279","510","240","104","1572"
201718,"Coventry and Warwickshire","LEP","Level 3","3843","537","1578","493","220","6671"
201718,"Coventry and Warwickshire","LEP","Total","4511","1035","2530","1126","505","9707"
201819,"Coventry and Warwickshire","LEP","All other qualifications","330","254","488","490","183","1745"
201819,"Coventry and Warwickshire","LEP","Level 2","741","294","776","364","150","2325"
201819,"Coventry and Warwickshire","LEP","Level 3","3692","502","1593","470","189","6446"
201819,"Coventry and Warwickshire","LEP","Total","4763","1050","2857","1324","522","10516"
201920,"Coventry and Warwickshire","LEP","All other qualifications","319","247","528","533","185","1812"
201920,"Coventry and Warwickshire","LEP","Level 2","418","226","523","264","96","1527"
201920,"Coventry and Warwickshire","LEP","Level 3","3798","422","1426","458","176","6280"
201920,"Coventry and Warwickshire","LEP","Total","4535","895","2477","1255","457","9619"
202021,"Coventry and Warwickshire","LEP","All other qualifications","462","206","469","679","197","2013"
202021,"Coventry and Warwickshire","LEP","Level 2","629","199","428","340","87","1683"
202021,"Coventry and Warwickshire","LEP","Level 3","3992","300","1279","568","176","6315"
202021,"Coventry and Warwickshire","LEP","Total","5083","705","2176","1587","460","10011"
201718,"Cumbria","LEP","All other qualifications","61","116","185","140","56","558"
201718,"Cumbria","LEP","Level 2","150","279","268","150","51","898"
201718,"Cumbria","LEP","Level 3","1596","458","696","193","110","3053"
201718,"Cumbria","LEP","Total","1807","853","1149","483","217","4509"
201819,"Cumbria","LEP","All other qualifications","49","125","151","161","48","534"
201819,"Cumbria","LEP","Level 2","176","254","296","131","34","891"
201819,"Cumbria","LEP","Level 3","1356","362","586","175","77","2556"
201819,"Cumbria","LEP","Total","1581","741","1033","467","159","3981"
201920,"Cumbria","LEP","All other qualifications","73","151","139","155","37","555"
201920,"Cumbria","LEP","Level 2","129","208","189","106","34","666"
201920,"Cumbria","LEP","Level 3","1383","375","572","211","101","2642"
201920,"Cumbria","LEP","Total","1585","734","900","472","172","3863"
202021,"Cumbria","LEP","All other qualifications","85","86","130","156","35","492"
202021,"Cumbria","LEP","Level 2","163","163","135","106","15","582"
202021,"Cumbria","LEP","Level 3","1383","273","574","230","76","2536"
202021,"Cumbria","LEP","Total","1631","522","839","492","126","3610"
201718,"Derby, Derbyshire, Nottingham and Nottinghamshire","LEP","All other qualifications","506","477","709","800","348","2840"
201718,"Derby, Derbyshire, Nottingham and Nottinghamshire","LEP","Level 2","766","624","1071","579","178","3218"
201718,"Derby, Derbyshire, Nottingham and Nottinghamshire","LEP","Level 3","6779","1130","2689","889","405","11892"
201718,"Derby, Derbyshire, Nottingham and Nottinghamshire","LEP","Total","8051","2231","4469","2268","931","17950"
201819,"Derby, Derbyshire, Nottingham and Nottinghamshire","LEP","All other qualifications","501","461","694","779","264","2699"
201819,"Derby, Derbyshire, Nottingham and Nottinghamshire","LEP","Level 2","661","685","1185","592","194","3317"
201819,"Derby, Derbyshire, Nottingham and Nottinghamshire","LEP","Level 3","6040","895","2372","797","341","10445"
201819,"Derby, Derbyshire, Nottingham and Nottinghamshire","LEP","Total","7202","2041","4251","2168","799","16461"
201920,"Derby, Derbyshire, Nottingham and Nottinghamshire","LEP","All other qualifications","628","481","779","895","281","3064"
201920,"Derby, Derbyshire, Nottingham and Nottinghamshire","LEP","Level 2","850","532","960","650","143","3135"
201920,"Derby, Derbyshire, Nottingham and Nottinghamshire","LEP","Level 3","6286","845","2494","882","352","10859"
201920,"Derby, Derbyshire, Nottingham and Nottinghamshire","LEP","Total","7764","1858","4233","2427","776","17058"
202021,"Derby, Derbyshire, Nottingham and Nottinghamshire","LEP","All other qualifications","756","448","739","926","297","3166"
202021,"Derby, Derbyshire, Nottingham and Nottinghamshire","LEP","Level 2","944","468","860","624","120","3016"
202021,"Derby, Derbyshire, Nottingham and Nottinghamshire","LEP","Level 3","6706","609","2032","875","308","10530"
202021,"Derby, Derbyshire, Nottingham and Nottinghamshire","LEP","Total","8406","1525","3631","2425","725","16712"
201718,"Dorset","LEP","All other qualifications","83","137","263","236","107","826"
201718,"Dorset","LEP","Level 2","102","246","428","169","78","1023"
201718,"Dorset","LEP","Level 3","2365","303","1504","428","244","4844"
201718,"Dorset","LEP","Total","2550","686","2195","833","429","6693"
201819,"Dorset","LEP","All other qualifications","129","89","253","223","85","779"
201819,"Dorset","LEP","Level 2","245","231","524","242","73","1315"
201819,"Dorset","LEP","Level 3","2124","257","1329","358","237","4305"
201819,"Dorset","LEP","Total","2498","577","2106","823","395","6399"
201920,"Dorset","LEP","All other qualifications","182","113","266","241","107","909"
201920,"Dorset","LEP","Level 2","222","187","375","191","60","1035"
201920,"Dorset","LEP","Level 3","2294","286","1381","447","252","4660"
201920,"Dorset","LEP","Total","2698","586","2022","879","419","6604"
202021,"Dorset","LEP","All other qualifications","192","112","231","248","77","860"
202021,"Dorset","LEP","Level 2","276","150","296","174","56","952"
202021,"Dorset","LEP","Level 3","2418","160","1169","390","194","4331"
202021,"Dorset","LEP","Total","2886","422","1696","812","327","6143"
201718,"Enterprise M3","LEP","All other qualifications","182","220","506","344","191","1443"
201718,"Enterprise M3","LEP","Level 2","268","252","783","336","129","1768"
201718,"Enterprise M3","LEP","Level 3","6530","590","3935","1006","410","12471"
201718,"Enterprise M3","LEP","Total","6980","1062","5224","1686","730","15682"
201819,"Enterprise M3","LEP","All other qualifications","189","172","479","338","216","1394"
201819,"Enterprise M3","LEP","Level 2","434","263","1101","414","141","2353"
201819,"Enterprise M3","LEP","Level 3","6075","524","3549","837","360","11345"
201819,"Enterprise M3","LEP","Total","6698","959","5129","1589","717","15092"
201920,"Enterprise M3","LEP","All other qualifications","243","162","518","380","159","1462"
201920,"Enterprise M3","LEP","Level 2","296","204","733","303","103","1639"
201920,"Enterprise M3","LEP","Level 3","6415","439","3589","878","402","11723"
201920,"Enterprise M3","LEP","Total","6954","805","4840","1561","664","14824"
202021,"Enterprise M3","LEP","All other qualifications","285","198","494","368","168","1513"
202021,"Enterprise M3","LEP","Level 2","421","149","552","286","99","1507"
202021,"Enterprise M3","LEP","Level 3","6020","302","2780","914","364","10380"
202021,"Enterprise M3","LEP","Total","6726","649","3826","1568","631","13400"
201718,"Gloucestershire","LEP","All other qualifications","100","98","190","143","63","594"
201718,"Gloucestershire","LEP","Level 2","153","113","312","106","55","739"
201718,"Gloucestershire","LEP","Level 3","2756","353","1478","362","212","5161"
201718,"Gloucestershire","LEP","Total","3009","564","1980","611","330","6494"
201819,"Gloucestershire","LEP","All other qualifications","117","108","212","127","60","624"
201819,"Gloucestershire","LEP","Level 2","213","154","284","114","35","800"
201819,"Gloucestershire","LEP","Level 3","2628","367","1477","374","181","5027"
201819,"Gloucestershire","LEP","Total","2958","629","1973","615","276","6451"
201920,"Gloucestershire","LEP","All other qualifications","170","93","202","143","48","656"
201920,"Gloucestershire","LEP","Level 2","130","109","259","117","37","652"
201920,"Gloucestershire","LEP","Level 3","2511","348","1435","401","195","4890"
201920,"Gloucestershire","LEP","Total","2811","550","1896","661","280","6198"
202021,"Gloucestershire","LEP","All other qualifications","141","115","197","192","46","691"
202021,"Gloucestershire","LEP","Level 2","229","90","232","110","33","694"
202021,"Gloucestershire","LEP","Level 3","2622","252","1324","461","191","4850"
202021,"Gloucestershire","LEP","Total","2992","457","1753","763","270","6235"
201718,"Greater Birmingham and Solihull","LEP","All other qualifications","525","439","884","1039","509","3396"
201718,"Greater Birmingham and Solihull","LEP","Level 2","928","455","920","622","278","3203"
201718,"Greater Birmingham and Solihull","LEP","Level 3","9366","1127","3090","1396","694","15673"
201718,"Greater Birmingham and Solihull","LEP","Total","10819","2021","4894","3057","1481","22272"
201819,"Greater Birmingham and Solihull","LEP","All other qualifications","512","432","830","1103","449","3326"
201819,"Greater Birmingham and Solihull","LEP","Level 2","1181","581","1281","876","280","4199"
201819,"Greater Birmingham and Solihull","LEP","Level 3","8486","963","2671","1334","571","14025"
201819,"Greater Birmingham and Solihull","LEP","Total","10179","1976","4782","3313","1300","21550"
201920,"Greater Birmingham and Solihull","LEP","All other qualifications","538","342","719","1035","445","3079"
201920,"Greater Birmingham and Solihull","LEP","Level 2","977","410","871","752","199","3209"
201920,"Greater Birmingham and Solihull","LEP","Level 3","8955","861","2832","1309","546","14503"
201920,"Greater Birmingham and Solihull","LEP","Total","10470","1613","4422","3096","1190","20791"
202021,"Greater Birmingham and Solihull","LEP","All other qualifications","859","362","659","1085","407","3372"
202021,"Greater Birmingham and Solihull","LEP","Level 2","1536","322","722","857","199","3636"
202021,"Greater Birmingham and Solihull","LEP","Level 3","8958","603","2124","1639","516","13840"
202021,"Greater Birmingham and Solihull","LEP","Total","11353","1287","3505","3581","1122","20848"
201718,"Greater Cambridge and Greater Peterborough","LEP","All other qualifications","187","155","401","330","199","1272"
201718,"Greater Cambridge and Greater Peterborough","LEP","Level 2","390","144","438","186","95","1253"
201718,"Greater Cambridge and Greater Peterborough","LEP","Level 3","2851","314","1743","409","221","5538"
201718,"Greater Cambridge and Greater Peterborough","LEP","Total","3428","613","2582","925","515","8063"
201819,"Greater Cambridge and Greater Peterborough","LEP","All other qualifications","182","168","433","355","181","1319"
201819,"Greater Cambridge and Greater Peterborough","LEP","Level 2","289","198","574","221","142","1424"
201819,"Greater Cambridge and Greater Peterborough","LEP","Level 3","2809","310","1591","409","218","5337"
201819,"Greater Cambridge and Greater Peterborough","LEP","Total","3280","676","2598","985","541","8080"
201920,"Greater Cambridge and Greater Peterborough","LEP","All other qualifications","241","154","424","344","156","1319"
201920,"Greater Cambridge and Greater Peterborough","LEP","Level 2","268","128","455","206","69","1126"
201920,"Greater Cambridge and Greater Peterborough","LEP","Level 3","3060","266","1739","442","238","5745"
201920,"Greater Cambridge and Greater Peterborough","LEP","Total","3569","548","2618","992","463","8190"
202021,"Greater Cambridge and Greater Peterborough","LEP","All other qualifications","277","145","384","368","130","1304"
202021,"Greater Cambridge and Greater Peterborough","LEP","Level 2","362","84","346","176","68","1036"
202021,"Greater Cambridge and Greater Peterborough","LEP","Level 3","3380","192","1427","545","264","5808"
202021,"Greater Cambridge and Greater Peterborough","LEP","Total","4019","421","2157","1089","462","8148"
201718,"Greater Lincolnshire","LEP","All other qualifications","296","280","460","522","202","1760"
201718,"Greater Lincolnshire","LEP","Level 2","461","339","657","378","115","1950"
201718,"Greater Lincolnshire","LEP","Level 3","4420","645","1741","564","330","7700"
201718,"Greater Lincolnshire","LEP","Total","5177","1264","2858","1464","647","11410"
201819,"Greater Lincolnshire","LEP","All other qualifications","339","298","470","549","167","1823"
201819,"Greater Lincolnshire","LEP","Level 2","742","476","906","505","120","2749"
201819,"Greater Lincolnshire","LEP","Level 3","4102","619","1524","565","281","7091"
201819,"Greater Lincolnshire","LEP","Total","5183","1393","2900","1619","568","11663"
201920,"Greater Lincolnshire","LEP","All other qualifications","361","263","502","631","158","1915"
201920,"Greater Lincolnshire","LEP","Level 2","496","395","683","475","108","2157"
201920,"Greater Lincolnshire","LEP","Level 3","4498","548","1674","642","248","7610"
201920,"Greater Lincolnshire","LEP","Total","5355","1206","2859","1748","514","11682"
202021,"Greater Lincolnshire","LEP","All other qualifications","505","303","533","778","182","2301"
202021,"Greater Lincolnshire","LEP","Level 2","798","306","751","611","116","2582"
202021,"Greater Lincolnshire","LEP","Level 3","4710","427","1634","758","287","7816"
202021,"Greater Lincolnshire","LEP","Total","6013","1036","2918","2147","585","12699"
201718,"Greater Manchester","LEP","All other qualifications","753","632","956","1304","617","4262"
201718,"Greater Manchester","LEP","Level 2","1135","685","1329","865","323","4337"
201718,"Greater Manchester","LEP","Level 3","11460","1554","4069","1651","767","19501"
201718,"Greater Manchester","LEP","Total","13348","2871","6354","3820","1707","28100"
201819,"Greater Manchester","LEP","All other qualifications","879","595","969","1336","547","4326"
201819,"Greater Manchester","LEP","Level 2","2258","695","1698","1235","325","6211"
201819,"Greater Manchester","LEP","Level 3","11104","1392","3589","1474","628","18187"
201819,"Greater Manchester","LEP","Total","14241","2682","6256","4045","1500","28724"
201920,"Greater Manchester","LEP","All other qualifications","806","573","1001","1392","566","4338"
201920,"Greater Manchester","LEP","Level 2","1085","533","1075","920","244","3857"
201920,"Greater Manchester","LEP","Level 3","11639","1253","3871","1820","672","19255"
201920,"Greater Manchester","LEP","Total","13530","2359","5947","4132","1482","27450"
202021,"Greater Manchester","LEP","All other qualifications","1513","561","989","1699","514","5276"
202021,"Greater Manchester","LEP","Level 2","2652","505","1060","1215","234","5666"
202021,"Greater Manchester","LEP","Level 3","12441","833","3236","2338","771","19619"
202021,"Greater Manchester","LEP","Total","16606","1899","5285","5252","1519","30561"
<<<<<<< HEAD
201718,"Heart of South West","LEP","All other qualifications","11","27","46","40","17","141"
201718,"Heart of South West","LEP","Level 2","9","26","52","23","10","120"
201718,"Heart of South West","LEP","Level 3","516","68","308","104","30","1026"
201718,"Heart of South West","LEP","Total","536","121","406","167","57","1287"
201819,"Heart of South West","LEP","All other qualifications","20","19","40","18","11","108"
201819,"Heart of South West","LEP","Level 2","13","18","32","12","6","81"
201819,"Heart of South West","LEP","Level 3","391","67","281","82","35","856"
201819,"Heart of South West","LEP","Total","424","104","353","112","52","1045"
201718,"Heart of the South West","LEP","All other qualifications","327","344","545","629","226","2071"
201718,"Heart of the South West","LEP","Level 2","517","580","992","480","184","2753"
201718,"Heart of the South West","LEP","Level 3","4790","835","3043","844","356","9868"
201718,"Heart of the South West","LEP","Total","5634","1759","4580","1953","766","14692"
201819,"Heart of the South West","LEP","All other qualifications","334","345","572","647","193","2091"
201819,"Heart of the South West","LEP","Level 2","808","757","1368","656","186","3775"
201819,"Heart of the South West","LEP","Level 3","4542","720","2925","772","326","9285"
201819,"Heart of the South West","LEP","Total","5684","1822","4865","2075","705","15151"
=======
201718,"Heart of the South West","LEP","All other qualifications","338","371","591","669","243","2212"
201718,"Heart of the South West","LEP","Level 2","526","606","1044","503","194","2873"
201718,"Heart of the South West","LEP","Level 3","5306","903","3351","948","386","10894"
201718,"Heart of the South West","LEP","Total","6170","1880","4986","2120","823","15979"
201819,"Heart of the South West","LEP","All other qualifications","354","364","612","665","204","2199"
201819,"Heart of the South West","LEP","Level 2","821","775","1400","668","192","3856"
201819,"Heart of the South West","LEP","Level 3","4933","787","3206","854","361","10141"
201819,"Heart of the South West","LEP","Total","6108","1926","5218","2187","757","16196"
>>>>>>> d231ffba6719ce99eeb75ba59dbf3d8e79efd608
201920,"Heart of the South West","LEP","All other qualifications","360","388","646","708","258","2360"
201920,"Heart of the South West","LEP","Level 2","498","590","1008","546","141","2783"
201920,"Heart of the South West","LEP","Level 3","4785","818","3115","972","412","10102"
201920,"Heart of the South West","LEP","Total","5643","1796","4769","2226","811","15245"
202021,"Heart of the South West","LEP","All other qualifications","475","391","604","706","198","2374"
202021,"Heart of the South West","LEP","Level 2","926","490","863","626","133","3038"
202021,"Heart of the South West","LEP","Level 3","5321","587","2988","1046","411","10353"
202021,"Heart of the South West","LEP","Total","6722","1468","4455","2378","742","15765"
201718,"Hertfordshire","LEP","All other qualifications","280","201","459","416","185","1541"
201718,"Hertfordshire","LEP","Level 2","496","229","590","277","110","1702"
201718,"Hertfordshire","LEP","Level 3","6048","533","2367","642","343","9933"
201718,"Hertfordshire","LEP","Total","6824","963","3416","1335","638","13176"
201819,"Hertfordshire","LEP","All other qualifications","163","169","395","407","179","1313"
201819,"Hertfordshire","LEP","Level 2","604","316","791","371","162","2244"
201819,"Hertfordshire","LEP","Level 3","5895","491","2258","633","311","9588"
201819,"Hertfordshire","LEP","Total","6662","976","3444","1411","652","13145"
201920,"Hertfordshire","LEP","All other qualifications","311","188","422","455","183","1559"
201920,"Hertfordshire","LEP","Level 2","395","233","659","333","125","1745"
201920,"Hertfordshire","LEP","Level 3","6192","527","2483","756","334","10292"
201920,"Hertfordshire","LEP","Total","6898","948","3564","1544","642","13596"
202021,"Hertfordshire","LEP","All other qualifications","453","150","446","519","197","1765"
202021,"Hertfordshire","LEP","Level 2","773","184","531","376","116","1980"
202021,"Hertfordshire","LEP","Level 3","6635","317","2030","894","393","10269"
202021,"Hertfordshire","LEP","Total","7861","651","3007","1789","706","14014"
201718,"Hull and East Yorkshire","LEP","All other qualifications","90","194","290","342","123","1039"
201718,"Hull and East Yorkshire","LEP","Level 2","202","195","369","269","92","1127"
201718,"Hull and East Yorkshire","LEP","Level 3","2193","364","911","360","142","3970"
201718,"Hull and East Yorkshire","LEP","Total","2485","753","1570","971","357","6136"
201819,"Hull and East Yorkshire","LEP","All other qualifications","121","159","220","304","88","892"
201819,"Hull and East Yorkshire","LEP","Level 2","266","213","422","347","79","1327"
201819,"Hull and East Yorkshire","LEP","Level 3","1978","328","765","312","110","3493"
201819,"Hull and East Yorkshire","LEP","Total","2365","700","1407","963","277","5712"
201920,"Hull and East Yorkshire","LEP","All other qualifications","163","163","212","326","94","958"
201920,"Hull and East Yorkshire","LEP","Level 2","226","156","298","267","45","992"
201920,"Hull and East Yorkshire","LEP","Level 3","2050","349","836","365","133","3733"
201920,"Hull and East Yorkshire","LEP","Total","2439","668","1346","958","272","5683"
202021,"Hull and East Yorkshire","LEP","All other qualifications","270","192","219","323","84","1088"
202021,"Hull and East Yorkshire","LEP","Level 2","379","113","249","260","41","1042"
202021,"Hull and East Yorkshire","LEP","Level 3","2362","259","679","435","86","3821"
202021,"Hull and East Yorkshire","LEP","Total","3011","564","1147","1018","211","5951"
201718,"Lancashire","LEP","All other qualifications","411","349","426","712","293","2191"
201718,"Lancashire","LEP","Level 2","610","373","606","414","139","2142"
201718,"Lancashire","LEP","Level 3","6446","840","2240","855","382","10763"
201718,"Lancashire","LEP","Total","7467","1562","3272","1981","814","15096"
201819,"Lancashire","LEP","All other qualifications","443","329","459","751","295","2277"
201819,"Lancashire","LEP","Level 2","856","467","827","560","165","2875"
201819,"Lancashire","LEP","Level 3","5879","824","2031","716","312","9762"
201819,"Lancashire","LEP","Total","7178","1620","3317","2027","772","14914"
201920,"Lancashire","LEP","All other qualifications","393","383","513","826","313","2428"
201920,"Lancashire","LEP","Level 2","395","319","573","487","104","1878"
201920,"Lancashire","LEP","Level 3","6234","738","2186","840","356","10354"
201920,"Lancashire","LEP","Total","7022","1440","3272","2153","773","14660"
202021,"Lancashire","LEP","All other qualifications","673","366","537","956","235","2767"
202021,"Lancashire","LEP","Level 2","991","331","570","574","113","2579"
202021,"Lancashire","LEP","Level 3","6315","613","2111","1138","360","10537"
202021,"Lancashire","LEP","Total","7979","1310","3218","2668","708","15883"
201718,"Leeds City Region","LEP","All other qualifications","618","475","716","1204","498","3511"
201718,"Leeds City Region","LEP","Level 2","983","587","935","703","262","3470"
201718,"Leeds City Region","LEP","Level 3","9661","1371","2987","1346","568","15933"
201718,"Leeds City Region","LEP","Total","11262","2433","4638","3253","1328","22914"
201819,"Leeds City Region","LEP","All other qualifications","541","417","716","1143","483","3300"
201819,"Leeds City Region","LEP","Level 2","1266","686","1159","907","278","4296"
201819,"Leeds City Region","LEP","Level 3","8524","1122","2680","1161","451","13938"
201819,"Leeds City Region","LEP","Total","10331","2225","4555","3211","1212","21534"
201920,"Leeds City Region","LEP","All other qualifications","624","491","706","1128","424","3373"
201920,"Leeds City Region","LEP","Level 2","1021","547","939","902","208","3617"
201920,"Leeds City Region","LEP","Level 3","8932","1104","2780","1315","509","14640"
201920,"Leeds City Region","LEP","Total","10577","2142","4425","3345","1141","21630"
202021,"Leeds City Region","LEP","All other qualifications","899","490","708","1281","405","3783"
202021,"Leeds City Region","LEP","Level 2","1766","450","812","1104","263","4395"
202021,"Leeds City Region","LEP","Level 3","9924","790","2352","1603","496","15165"
202021,"Leeds City Region","LEP","Total","12589","1730","3872","3988","1164","23343"
201718,"Leicester and Leicestershire","LEP","All other qualifications","163","233","385","415","182","1378"
201718,"Leicester and Leicestershire","LEP","Level 2","310","316","488","242","80","1436"
201718,"Leicester and Leicestershire","LEP","Level 3","4160","547","1495","547","262","7011"
201718,"Leicester and Leicestershire","LEP","Total","4633","1096","2368","1204","524","9825"
201819,"Leicester and Leicestershire","LEP","All other qualifications","185","172","357","327","151","1192"
201819,"Leicester and Leicestershire","LEP","Level 2","569","334","696","371","119","2089"
201819,"Leicester and Leicestershire","LEP","Level 3","3987","449","1386","493","266","6581"
201819,"Leicester and Leicestershire","LEP","Total","4741","955","2439","1191","536","9862"
201920,"Leicester and Leicestershire","LEP","All other qualifications","212","170","379","369","173","1303"
201920,"Leicester and Leicestershire","LEP","Level 2","263","261","456","280","94","1354"
201920,"Leicester and Leicestershire","LEP","Level 3","4189","433","1442","565","292","6921"
201920,"Leicester and Leicestershire","LEP","Total","4664","864","2277","1214","559","9578"
202021,"Leicester and Leicestershire","LEP","All other qualifications","349","208","375","413","160","1505"
202021,"Leicester and Leicestershire","LEP","Level 2","568","215","428","319","99","1629"
202021,"Leicester and Leicestershire","LEP","Level 3","4258","280","1372","719","302","6931"
202021,"Leicester and Leicestershire","LEP","Total","5175","703","2175","1451","561","10065"
201718,"Liverpool City Region","LEP","All other qualifications","346","337","398","567","252","1900"
201718,"Liverpool City Region","LEP","Level 2","763","384","694","482","145","2468"
201718,"Liverpool City Region","LEP","Level 3","6337","741","2191","847","406","10522"
201718,"Liverpool City Region","LEP","Total","7446","1462","3283","1896","803","14890"
201819,"Liverpool City Region","LEP","All other qualifications","308","322","469","635","214","1948"
201819,"Liverpool City Region","LEP","Level 2","869","437","775","621","147","2849"
201819,"Liverpool City Region","LEP","Level 3","5638","589","1838","844","268","9177"
201819,"Liverpool City Region","LEP","Total","6815","1348","3082","2100","629","13974"
201920,"Liverpool City Region","LEP","All other qualifications","423","339","543","702","230","2237"
201920,"Liverpool City Region","LEP","Level 2","781","361","731","569","134","2576"
201920,"Liverpool City Region","LEP","Level 3","5608","592","1952","867","331","9350"
201920,"Liverpool City Region","LEP","Total","6812","1292","3226","2138","695","14163"
202021,"Liverpool City Region","LEP","All other qualifications","515","324","568","860","212","2479"
202021,"Liverpool City Region","LEP","Level 2","924","275","621","602","108","2530"
202021,"Liverpool City Region","LEP","Level 3","6116","360","1620","1051","258","9405"
202021,"Liverpool City Region","LEP","Total","7555","959","2809","2513","578","14414"
201718,"London","LEP","All other qualifications","2488","874","2044","2865","2211","10482"
201718,"London","LEP","Level 2","3006","859","1913","1597","924","8299"
201718,"London","LEP","Level 3","38602","2225","8589","4617","2819","56852"
201718,"London","LEP","Total","44096","3958","12546","9079","5954","75633"
201819,"London","LEP","All other qualifications","2550","794","2144","2973","2046","10507"
201819,"London","LEP","Level 2","4953","888","2504","2162","1029","11536"
201819,"London","LEP","Level 3","37613","1988","8521","4424","2635","55181"
201819,"London","LEP","Total","45116","3670","13169","9559","5710","77224"
201920,"London","LEP","All other qualifications","2752","711","2141","3250","1827","10681"
201920,"London","LEP","Level 2","2923","681","1757","1784","793","7938"
201920,"London","LEP","Level 3","39970","1752","8957","4761","2682","58122"
201920,"London","LEP","Total","45645","3144","12855","9795","5302","76741"
202021,"London","LEP","All other qualifications","3647","685","1975","3451","1661","11419"
202021,"London","LEP","Level 2","5377","499","1523","1982","736","10117"
202021,"London","LEP","Level 3","42491","1150","6075","6162","2908","58786"
202021,"London","LEP","Total","51515","2334","9573","11595","5305","80322"
201718,"New Anglia","LEP","All other qualifications","402","306","663","703","273","2347"
201718,"New Anglia","LEP","Level 2","540","449","1094","465","194","2742"
201718,"New Anglia","LEP","Level 3","4870","784","3076","836","371","9937"
201718,"New Anglia","LEP","Total","5812","1539","4833","2004","838","15026"
201819,"New Anglia","LEP","All other qualifications","283","291","637","724","213","2148"
201819,"New Anglia","LEP","Level 2","765","524","1343","626","215","3473"
201819,"New Anglia","LEP","Level 3","4438","728","2714","796","330","9006"
201819,"New Anglia","LEP","Total","5486","1543","4694","2146","758","14627"
201920,"New Anglia","LEP","All other qualifications","496","296","695","730","217","2434"
201920,"New Anglia","LEP","Level 2","568","433","1095","561","159","2816"
201920,"New Anglia","LEP","Level 3","4568","726","2810","927","329","9360"
201920,"New Anglia","LEP","Total","5632","1455","4600","2218","705","14610"
202021,"New Anglia","LEP","All other qualifications","553","318","629","765","205","2470"
202021,"New Anglia","LEP","Level 2","973","328","892","564","156","2913"
202021,"New Anglia","LEP","Level 3","5119","486","2609","1000","309","9523"
202021,"New Anglia","LEP","Total","6645","1132","4130","2329","670","14906"
201718,"North East","LEP","All other qualifications","431","686","681","1260","531","3589"
201718,"North East","LEP","Level 2","554","548","787","633","194","2716"
201718,"North East","LEP","Level 3","7227","1450","2359","1128","471","12635"
201718,"North East","LEP","Total","8212","2684","3827","3021","1196","18940"
201819,"North East","LEP","All other qualifications","613","615","765","1319","513","3825"
201819,"North East","LEP","Level 2","1127","678","1141","1072","217","4235"
201819,"North East","LEP","Level 3","6708","1209","2167","995","338","11417"
201819,"North East","LEP","Total","8448","2502","4073","3386","1068","19477"
201920,"North East","LEP","All other qualifications","614","580","782","1339","442","3757"
201920,"North East","LEP","Level 2","861","601","867","915","170","3414"
201920,"North East","LEP","Level 3","7167","1187","2376","1282","374","12386"
201920,"North East","LEP","Total","8642","2368","4025","3536","986","19557"
202021,"North East","LEP","All other qualifications","858","548","769","1520","443","4138"
202021,"North East","LEP","Level 2","1341","538","849","1033","199","3960"
202021,"North East","LEP","Level 3","7998","752","2068","1465","430","12713"
202021,"North East","LEP","Total","10197","1838","3686","4018","1072","20811"
201718,"Oxfordshire","LEP","All other qualifications","187","126","385","234","106","1038"
201718,"Oxfordshire","LEP","Level 2","261","129","434","175","64","1063"
201718,"Oxfordshire","LEP","Level 3","2534","349","1628","430","185","5126"
201718,"Oxfordshire","LEP","Total","2982","604","2447","839","355","7227"
201819,"Oxfordshire","LEP","All other qualifications","108","125","362","237","122","954"
201819,"Oxfordshire","LEP","Level 2","205","131","634","223","81","1274"
201819,"Oxfordshire","LEP","Level 3","2224","289","1557","342","177","4589"
201819,"Oxfordshire","LEP","Total","2537","545","2553","802","380","6817"
201920,"Oxfordshire","LEP","All other qualifications","149","111","409","257","129","1055"
201920,"Oxfordshire","LEP","Level 2","203","140","593","246","93","1275"
201920,"Oxfordshire","LEP","Level 3","2406","271","1634","419","189","4919"
201920,"Oxfordshire","LEP","Total","2758","522","2636","922","411","7249"
202021,"Oxfordshire","LEP","All other qualifications","296","139","435","296","178","1344"
202021,"Oxfordshire","LEP","Level 2","656","155","605","396","109","1921"
202021,"Oxfordshire","LEP","Level 3","2867","180","1634","546","234","5461"
202021,"Oxfordshire","LEP","Total","3819","474","2674","1238","521","8726"
201718,"Sheffield City Region","LEP","All other qualifications","310","386","486","621","292","2095"
201718,"Sheffield City Region","LEP","Level 2","525","420","784","482","165","2376"
201718,"Sheffield City Region","LEP","Level 3","4676","754","1889","705","325","8349"
201718,"Sheffield City Region","LEP","Total","5511","1560","3159","1808","782","12820"
201819,"Sheffield City Region","LEP","All other qualifications","330","332","550","665","246","2123"
201819,"Sheffield City Region","LEP","Level 2","758","427","1096","691","156","3128"
201819,"Sheffield City Region","LEP","Level 3","4325","655","1653","630","186","7449"
201819,"Sheffield City Region","LEP","Total","5413","1414","3299","1986","588","12700"
201920,"Sheffield City Region","LEP","All other qualifications","382","358","554","707","240","2241"
201920,"Sheffield City Region","LEP","Level 2","435","353","620","500","119","2027"
201920,"Sheffield City Region","LEP","Level 3","4709","593","1640","699","215","7856"
201920,"Sheffield City Region","LEP","Total","5526","1304","2814","1906","574","12124"
202021,"Sheffield City Region","LEP","All other qualifications","594","302","521","826","233","2476"
202021,"Sheffield City Region","LEP","Level 2","887","266","528","487","94","2262"
202021,"Sheffield City Region","LEP","Level 3","4907","342","1478","830","235","7792"
202021,"Sheffield City Region","LEP","Total","6388","910","2527","2143","562","12530"
201718,"Solent","LEP","All other qualifications","316","328","454","556","237","1891"
201718,"Solent","LEP","Level 2","395","384","848","386","160","2173"
201718,"Solent","LEP","Level 3","3992","663","2621","707","312","8295"
201718,"Solent","LEP","Total","4703","1375","3923","1649","709","12359"
201819,"Solent","LEP","All other qualifications","313","265","577","585","221","1961"
201819,"Solent","LEP","Level 2","658","387","1061","483","154","2743"
201819,"Solent","LEP","Level 3","3834","519","2259","573","321","7506"
201819,"Solent","LEP","Total","4805","1171","3897","1641","696","12210"
201920,"Solent","LEP","All other qualifications","313","259","549","567","199","1887"
201920,"Solent","LEP","Level 2","337","355","654","402","115","1863"
201920,"Solent","LEP","Level 3","3689","530","2386","687","304","7596"
201920,"Solent","LEP","Total","4339","1144","3589","1656","618","11346"
202021,"Solent","LEP","All other qualifications","549","250","559","628","214","2200"
202021,"Solent","LEP","Level 2","797","261","665","466","131","2320"
202021,"Solent","LEP","Level 3","4393","373","2210","825","345","8146"
202021,"Solent","LEP","Total","5739","884","3434","1919","690","12666"
201718,"South East","LEP","All other qualifications","734","839","1564","1760","938","5835"
201718,"South East","LEP","Level 2","1427","876","2348","1367","569","6587"
201718,"South East","LEP","Level 3","15519","2135","8441","2495","1302","29892"
201718,"South East","LEP","Total","17680","3850","12353","5622","2809","42314"
201819,"South East","LEP","All other qualifications","731","752","1578","1734","798","5593"
201819,"South East","LEP","Level 2","1622","893","2692","1500","571","7278"
201819,"South East","LEP","Level 3","14283","1948","7428","2305","1070","27034"
201819,"South East","LEP","Total","16636","3593","11698","5539","2439","39905"
201920,"South East","LEP","All other qualifications","710","747","1656","1825","773","5711"
201920,"South East","LEP","Level 2","1144","761","2107","1362","466","5840"
201920,"South East","LEP","Level 3","14608","1623","7631","2440","1085","27387"
201920,"South East","LEP","Total","16462","3131","11394","5627","2324","38938"
202021,"South East","LEP","All other qualifications","1118","752","1762","2121","735","6488"
202021,"South East","LEP","Level 2","1960","772","2339","1796","517","7384"
202021,"South East","LEP","Level 3","16527","1216","7101","3136","1110","29090"
202021,"South East","LEP","Total","19605","2740","11202","7053","2362","42962"
201718,"South East Midlands","LEP","All other qualifications","475","335","757","650","316","2533"
201718,"South East Midlands","LEP","Level 2","840","394","975","458","169","2836"
201718,"South East Midlands","LEP","Level 3","6651","916","3034","879","377","11857"
201718,"South East Midlands","LEP","Total","7966","1645","4766","1987","862","17226"
201819,"South East Midlands","LEP","All other qualifications","432","358","777","675","289","2531"
201819,"South East Midlands","LEP","Level 2","945","376","1053","475","170","3019"
201819,"South East Midlands","LEP","Level 3","6105","761","2777","829","338","10810"
201819,"South East Midlands","LEP","Total","7482","1495","4607","1979","797","16360"
201920,"South East Midlands","LEP","All other qualifications","455","293","776","690","328","2542"
201920,"South East Midlands","LEP","Level 2","895","305","1021","515","177","2913"
201920,"South East Midlands","LEP","Level 3","6471","647","2885","900","339","11242"
201920,"South East Midlands","LEP","Total","7821","1245","4682","2105","844","16697"
202021,"South East Midlands","LEP","All other qualifications","434","302","695","682","225","2338"
202021,"South East Midlands","LEP","Level 2","974","269","883","483","128","2737"
202021,"South East Midlands","LEP","Level 3","6711","478","2623","1050","363","11225"
202021,"South East Midlands","LEP","Total","8119","1049","4201","2215","716","16300"
201718,"Stoke-on-Trent and Staffordshire","LEP","All other qualifications","220","216","433","470","158","1497"
201718,"Stoke-on-Trent and Staffordshire","LEP","Level 2","479","323","582","250","86","1720"
201718,"Stoke-on-Trent and Staffordshire","LEP","Level 3","3708","663","1589","493","166","6619"
201718,"Stoke-on-Trent and Staffordshire","LEP","Total","4407","1202","2604","1213","410","9836"
201819,"Stoke-on-Trent and Staffordshire","LEP","All other qualifications","189","228","401","405","144","1367"
201819,"Stoke-on-Trent and Staffordshire","LEP","Level 2","574","318","611","350","79","1932"
201819,"Stoke-on-Trent and Staffordshire","LEP","Level 3","3536","502","1525","452","188","6203"
201819,"Stoke-on-Trent and Staffordshire","LEP","Total","4299","1048","2537","1207","411","9502"
201920,"Stoke-on-Trent and Staffordshire","LEP","All other qualifications","242","205","417","411","132","1407"
201920,"Stoke-on-Trent and Staffordshire","LEP","Level 2","370","269","541","328","95","1603"
201920,"Stoke-on-Trent and Staffordshire","LEP","Level 3","3663","545","1518","530","193","6449"
201920,"Stoke-on-Trent and Staffordshire","LEP","Total","4275","1019","2476","1269","420","9459"
202021,"Stoke-on-Trent and Staffordshire","LEP","All other qualifications","343","208","347","415","136","1449"
202021,"Stoke-on-Trent and Staffordshire","LEP","Level 2","596","216","501","310","78","1701"
202021,"Stoke-on-Trent and Staffordshire","LEP","Level 3","3741","375","1431","633","156","6336"
202021,"Stoke-on-Trent and Staffordshire","LEP","Total","4680","799","2279","1358","370","9486"
201718,"Swindon and Wiltshire","LEP","All other qualifications","179","147","430","299","147","1202"
201718,"Swindon and Wiltshire","LEP","Level 2","267","184","466","150","55","1122"
201718,"Swindon and Wiltshire","LEP","Level 3","2194","324","1426","354","141","4439"
201718,"Swindon and Wiltshire","LEP","Total","2640","655","2322","803","343","6763"
201819,"Swindon and Wiltshire","LEP","All other qualifications","202","178","392","309","93","1174"
201819,"Swindon and Wiltshire","LEP","Level 2","328","208","490","173","65","1264"
201819,"Swindon and Wiltshire","LEP","Level 3","1968","268","1295","328","104","3963"
201819,"Swindon and Wiltshire","LEP","Total","2498","654","2177","810","262","6401"
201920,"Swindon and Wiltshire","LEP","All other qualifications","188","135","395","289","120","1127"
201920,"Swindon and Wiltshire","LEP","Level 2","291","133","412","204","52","1092"
201920,"Swindon and Wiltshire","LEP","Level 3","2024","218","1256","342","127","3967"
201920,"Swindon and Wiltshire","LEP","Total","2503","486","2063","835","299","6186"
202021,"Swindon and Wiltshire","LEP","All other qualifications","212","148","321","295","108","1084"
202021,"Swindon and Wiltshire","LEP","Level 2","413","108","378","230","50","1179"
202021,"Swindon and Wiltshire","LEP","Level 3","2290","146","1115","399","148","4098"
202021,"Swindon and Wiltshire","LEP","Total","2915","402","1814","924","306","6361"
201718,"Tees Valley","LEP","All other qualifications","114","221","188","382","145","1050"
201718,"Tees Valley","LEP","Level 2","302","218","288","268","80","1156"
201718,"Tees Valley","LEP","Level 3","3179","548","943","450","181","5301"
201718,"Tees Valley","LEP","Total","3595","987","1419","1100","406","7507"
201819,"Tees Valley","LEP","All other qualifications","135","200","227","428","129","1119"
201819,"Tees Valley","LEP","Level 2","639","303","459","449","73","1923"
201819,"Tees Valley","LEP","Level 3","2810","409","797","418","129","4563"
201819,"Tees Valley","LEP","Total","3584","912","1483","1295","331","7605"
201920,"Tees Valley","LEP","All other qualifications","214","278","270","434","85","1281"
201920,"Tees Valley","LEP","Level 2","361","219","230","312","37","1159"
201920,"Tees Valley","LEP","Level 3","2930","397","779","442","108","4656"
201920,"Tees Valley","LEP","Total","3505","894","1279","1188","230","7096"
202021,"Tees Valley","LEP","All other qualifications","251","269","237","536","103","1396"
202021,"Tees Valley","LEP","Level 2","506","183","247","329","38","1303"
202021,"Tees Valley","LEP","Level 3","3135","316","805","563","108","4927"
202021,"Tees Valley","LEP","Total","3892","768","1289","1428","249","7626"
201718,"Thames Valley Berkshire","LEP","All other qualifications","112","110","245","145","119","731"
201718,"Thames Valley Berkshire","LEP","Level 2","203","157","333","160","75","928"
201718,"Thames Valley Berkshire","LEP","Level 3","3495","406","1485","405","185","5976"
201718,"Thames Valley Berkshire","LEP","Total","3810","673","2063","710","379","7635"
201819,"Thames Valley Berkshire","LEP","All other qualifications","135","99","229","199","112","774"
201819,"Thames Valley Berkshire","LEP","Level 2","229","147","438","174","96","1084"
201819,"Thames Valley Berkshire","LEP","Level 3","3661","370","1484","426","230","6171"
201819,"Thames Valley Berkshire","LEP","Total","4025","616","2151","799","438","8029"
201920,"Thames Valley Berkshire","LEP","All other qualifications","157","107","255","210","119","848"
201920,"Thames Valley Berkshire","LEP","Level 2","210","93","286","144","73","806"
201920,"Thames Valley Berkshire","LEP","Level 3","3747","330","1639","428","201","6345"
201920,"Thames Valley Berkshire","LEP","Total","4114","530","2180","782","393","7999"
202021,"Thames Valley Berkshire","LEP","All other qualifications","196","95","255","234","125","905"
202021,"Thames Valley Berkshire","LEP","Level 2","278","69","200","143","52","742"
202021,"Thames Valley Berkshire","LEP","Level 3","3820","187","1270","497","258","6032"
202021,"Thames Valley Berkshire","LEP","Total","4294","351","1725","874","435","7679"
201718,"The Marches","LEP","All other qualifications","111","101","185","178","84","659"
201718,"The Marches","LEP","Level 2","138","177","357","199","84","955"
201718,"The Marches","LEP","Level 3","2476","366","1346","362","193","4743"
201718,"The Marches","LEP","Total","2725","644","1888","739","361","6357"
201819,"The Marches","LEP","All other qualifications","121","127","224","244","77","793"
201819,"The Marches","LEP","Level 2","218","245","566","294","102","1425"
201819,"The Marches","LEP","Level 3","2256","339","1316","365","174","4450"
201819,"The Marches","LEP","Total","2595","711","2106","903","353","6668"
201920,"The Marches","LEP","All other qualifications","138","144","240","215","71","808"
201920,"The Marches","LEP","Level 2","236","170","350","230","68","1054"
201920,"The Marches","LEP","Level 3","2511","338","1332","423","174","4778"
201920,"The Marches","LEP","Total","2885","652","1922","868","313","6640"
202021,"The Marches","LEP","All other qualifications","186","125","220","284","86","901"
202021,"The Marches","LEP","Level 2","340","111","284","262","59","1056"
202021,"The Marches","LEP","Level 3","2488","226","1148","433","167","4462"
202021,"The Marches","LEP","Total","3014","462","1652","979","312","6419"
201718,"West of England","LEP","All other qualifications","271","369","589","496","257","1982"
201718,"West of England","LEP","Level 2","383","312","759","299","121","1874"
201718,"West of England","LEP","Level 3","3567","611","2373","609","227","7387"
201718,"West of England","LEP","Total","4221","1292","3721","1404","605","11243"
201819,"West of England","LEP","All other qualifications","318","344","538","569","226","1995"
201819,"West of England","LEP","Level 2","662","332","799","406","127","2326"
201819,"West of England","LEP","Level 3","3279","565","2109","506","265","6724"
201819,"West of England","LEP","Total","4259","1241","3446","1481","618","11045"
201920,"West of England","LEP","All other qualifications","352","295","620","577","221","2065"
201920,"West of England","LEP","Level 2","430","321","668","311","92","1822"
201920,"West of England","LEP","Level 3","3478","474","2240","562","247","7001"
201920,"West of England","LEP","Total","4260","1090","3528","1450","560","10888"
202021,"West of England","LEP","All other qualifications","395","241","527","603","148","1914"
202021,"West of England","LEP","Level 2","580","291","635","353","83","1942"
202021,"West of England","LEP","Level 3","3771","319","1954","754","269","7067"
202021,"West of England","LEP","Total","4746","851","3116","1710","500","10923"
201718,"Worcestershire","LEP","All other qualifications","38","94","184","167","65","548"
201718,"Worcestershire","LEP","Level 2","42","94","141","76","23","376"
201718,"Worcestershire","LEP","Level 3","1751","340","803","250","99","3243"
201718,"Worcestershire","LEP","Total","1831","528","1128","493","187","4167"
201819,"Worcestershire","LEP","All other qualifications","41","114","193","178","69","595"
201819,"Worcestershire","LEP","Level 2","109","164","337","157","43","810"
201819,"Worcestershire","LEP","Level 3","1518","276","790","200","101","2885"
201819,"Worcestershire","LEP","Total","1668","554","1320","535","213","4290"
201920,"Worcestershire","LEP","All other qualifications","51","83","167","198","53","552"
201920,"Worcestershire","LEP","Level 2","67","117","200","116","29","529"
201920,"Worcestershire","LEP","Level 3","1422","239","808","228","115","2812"
201920,"Worcestershire","LEP","Total","1540","439","1175","542","197","3893"
202021,"Worcestershire","LEP","All other qualifications","98","91","166","171","53","579"
202021,"Worcestershire","LEP","Level 2","158","68","212","116","37","591"
202021,"Worcestershire","LEP","Level 3","1766","145","682","277","91","2961"
202021,"Worcestershire","LEP","Total","2022","304","1060","564","181","4131"
201718,"York and North Yorkshire","LEP","All other qualifications","84","137","230","223","84","758"
201718,"York and North Yorkshire","LEP","Level 2","130","234","474","192","93","1123"
201718,"York and North Yorkshire","LEP","Level 3","3485","502","1829","472","254","6542"
201718,"York and North Yorkshire","LEP","Total","3699","873","2533","887","431","8423"
201819,"York and North Yorkshire","LEP","All other qualifications","76","103","185","216","70","650"
201819,"York and North Yorkshire","LEP","Level 2","267","252","632","276","97","1524"
201819,"York and North Yorkshire","LEP","Level 3","3125","414","1479","415","206","5639"
201819,"York and North Yorkshire","LEP","Total","3468","769","2296","907","373","7813"
201920,"York and North Yorkshire","LEP","All other qualifications","93","147","262","256","85","843"
201920,"York and North Yorkshire","LEP","Level 2","154","181","426","226","81","1068"
201920,"York and North Yorkshire","LEP","Level 3","3274","382","1580","497","219","5952"
201920,"York and North Yorkshire","LEP","Total","3521","710","2268","979","385","7863"
202021,"York and North Yorkshire","LEP","All other qualifications","175","141","267","306","75","964"
202021,"York and North Yorkshire","LEP","Level 2","291","191","355","236","41","1114"
202021,"York and North Yorkshire","LEP","Level 3","3559","290","1439","538","269","6095"
202021,"York and North Yorkshire","LEP","Total","4025","622","2061","1080","385","8173"
201718,"Brighton and Hove, East Sussex, West Sussex","LSIP","All other qualifications","394","211","589","615","335","2144"
201718,"Brighton and Hove, East Sussex, West Sussex","LSIP","Level 2","592","321","939","477","235","2564"
201718,"Brighton and Hove, East Sussex, West Sussex","LSIP","Level 3","5368","575","3363","944","574","10824"
201718,"Brighton and Hove, East Sussex, West Sussex","LSIP","Total","6354","1107","4891","2036","1144","15532"
201819,"Brighton and Hove, East Sussex, West Sussex","LSIP","All other qualifications","424","227","630","632","321","2234"
201819,"Brighton and Hove, East Sussex, West Sussex","LSIP","Level 2","1035","301","1059","550","236","3181"
201819,"Brighton and Hove, East Sussex, West Sussex","LSIP","Level 3","5188","512","3358","911","537","10506"
201819,"Brighton and Hove, East Sussex, West Sussex","LSIP","Total","6647","1040","5047","2093","1094","15921"
201920,"Brighton and Hove, East Sussex, West Sussex","LSIP","All other qualifications","416","256","619","620","300","2211"
201920,"Brighton and Hove, East Sussex, West Sussex","LSIP","Level 2","598","234","757","453","181","2223"
201920,"Brighton and Hove, East Sussex, West Sussex","LSIP","Level 3","5242","385","3138","879","530","10174"
201920,"Brighton and Hove, East Sussex, West Sussex","LSIP","Total","6256","875","4514","1952","1011","14608"
202021,"Brighton and Hove, East Sussex, West Sussex","LSIP","All other qualifications","567","226","595","679","296","2363"
202021,"Brighton and Hove, East Sussex, West Sussex","LSIP","Level 2","927","224","783","590","178","2702"
202021,"Brighton and Hove, East Sussex, West Sussex","LSIP","Level 3","5664","306","2664","1128","573","10335"
202021,"Brighton and Hove, East Sussex, West Sussex","LSIP","Total","7158","756","4042","2397","1047","15400"
201718,"Buckinghamshire","LSIP","All other qualifications","40","75","148","85","55","403"
201718,"Buckinghamshire","LSIP","Level 2","69","71","169","69","26","404"
201718,"Buckinghamshire","LSIP","Level 3","2732","149","929","299","134","4243"
201718,"Buckinghamshire","LSIP","Total","2841","295","1246","453","215","5050"
201819,"Buckinghamshire","LSIP","All other qualifications","56","49","140","112","47","404"
201819,"Buckinghamshire","LSIP","Level 2","183","79","208","100","28","598"
201819,"Buckinghamshire","LSIP","Level 3","2490","146","867","246","141","3890"
201819,"Buckinghamshire","LSIP","Total","2729","274","1215","458","216","4892"
201920,"Buckinghamshire","LSIP","All other qualifications","53","43","142","118","61","417"
201920,"Buckinghamshire","LSIP","Level 2","64","60","130","42","18","314"
201920,"Buckinghamshire","LSIP","Level 3","2541","153","843","234","125","3896"
201920,"Buckinghamshire","LSIP","Total","2658","256","1115","394","204","4627"
202021,"Buckinghamshire","LSIP","All other qualifications","83","59","133","144","57","476"
202021,"Buckinghamshire","LSIP","Level 2","121","61","147","100","36","465"
202021,"Buckinghamshire","LSIP","Level 3","2630","117","769","292","154","3962"
202021,"Buckinghamshire","LSIP","Total","2834","237","1049","536","247","4903"
201718,"Cambridgeshire and Peterborough","LSIP","All other qualifications","187","155","401","330","199","1272"
201718,"Cambridgeshire and Peterborough","LSIP","Level 2","390","144","438","186","95","1253"
201718,"Cambridgeshire and Peterborough","LSIP","Level 3","2851","314","1743","409","221","5538"
201718,"Cambridgeshire and Peterborough","LSIP","Total","3428","613","2582","925","515","8063"
201819,"Cambridgeshire and Peterborough","LSIP","All other qualifications","182","168","433","355","181","1319"
201819,"Cambridgeshire and Peterborough","LSIP","Level 2","289","198","574","221","142","1424"
201819,"Cambridgeshire and Peterborough","LSIP","Level 3","2809","310","1591","409","218","5337"
201819,"Cambridgeshire and Peterborough","LSIP","Total","3280","676","2598","985","541","8080"
201920,"Cambridgeshire and Peterborough","LSIP","All other qualifications","241","154","424","344","156","1319"
201920,"Cambridgeshire and Peterborough","LSIP","Level 2","268","128","455","206","69","1126"
201920,"Cambridgeshire and Peterborough","LSIP","Level 3","3060","266","1739","442","238","5745"
201920,"Cambridgeshire and Peterborough","LSIP","Total","3569","548","2618","992","463","8190"
202021,"Cambridgeshire and Peterborough","LSIP","All other qualifications","277","145","384","368","130","1304"
202021,"Cambridgeshire and Peterborough","LSIP","Level 2","362","84","346","176","68","1036"
202021,"Cambridgeshire and Peterborough","LSIP","Level 3","3380","192","1427","545","264","5808"
202021,"Cambridgeshire and Peterborough","LSIP","Total","4019","421","2157","1089","462","8148"
201718,"Cheshire and Warrington","LSIP","All other qualifications","173","214","321","312","107","1127"
201718,"Cheshire and Warrington","LSIP","Level 2","285","223","460","198","96","1262"
201718,"Cheshire and Warrington","LSIP","Level 3","4126","621","1949","536","243","7475"
201718,"Cheshire and Warrington","LSIP","Total","4584","1058","2730","1046","446","9864"
201819,"Cheshire and Warrington","LSIP","All other qualifications","136","201","295","276","95","1003"
201819,"Cheshire and Warrington","LSIP","Level 2","431","284","669","309","110","1803"
201819,"Cheshire and Warrington","LSIP","Level 3","3860","624","1701","507","192","6884"
201819,"Cheshire and Warrington","LSIP","Total","4427","1109","2665","1092","397","9690"
201920,"Cheshire and Warrington","LSIP","All other qualifications","152","217","287","324","102","1082"
201920,"Cheshire and Warrington","LSIP","Level 2","238","196","455","243","69","1201"
201920,"Cheshire and Warrington","LSIP","Level 3","3884","550","1813","521","237","7005"
201920,"Cheshire and Warrington","LSIP","Total","4274","963","2555","1088","408","9288"
202021,"Cheshire and Warrington","LSIP","All other qualifications","289","180","272","343","91","1175"
202021,"Cheshire and Warrington","LSIP","Level 2","495","175","404","276","65","1415"
202021,"Cheshire and Warrington","LSIP","Level 3","4234","366","1617","666","222","7105"
202021,"Cheshire and Warrington","LSIP","Total","5018","721","2293","1285","378","9695"
201718,"Cornwall and the Isles of Scilly","LSIP","All other qualifications","174","109","245","259","77","864"
201718,"Cornwall and the Isles of Scilly","LSIP","Level 2","320","197","404","209","84","1214"
201718,"Cornwall and the Isles of Scilly","LSIP","Level 3","1820","209","1110","441","141","3721"
201718,"Cornwall and the Isles of Scilly","LSIP","Total","2314","515","1759","909","302","5799"
201819,"Cornwall and the Isles of Scilly","LSIP","All other qualifications","156","87","189","258","79","769"
201819,"Cornwall and the Isles of Scilly","LSIP","Level 2","294","231","449","245","70","1289"
201819,"Cornwall and the Isles of Scilly","LSIP","Level 3","1680","188","988","375","122","3353"
201819,"Cornwall and the Isles of Scilly","LSIP","Total","2130","506","1626","878","271","5411"
201920,"Cornwall and the Isles of Scilly","LSIP","All other qualifications","109","98","229","257","88","781"
201920,"Cornwall and the Isles of Scilly","LSIP","Level 2","154","171","361","226","53","965"
201920,"Cornwall and the Isles of Scilly","LSIP","Level 3","1693","213","1155","453","152","3666"
201920,"Cornwall and the Isles of Scilly","LSIP","Total","1956","482","1745","936","293","5412"
202021,"Cornwall and the Isles of Scilly","LSIP","All other qualifications","233","84","194","250","65","826"
202021,"Cornwall and the Isles of Scilly","LSIP","Level 2","330","156","330","251","57","1124"
202021,"Cornwall and the Isles of Scilly","LSIP","Level 3","1854","143","1168","447","123","3735"
202021,"Cornwall and the Isles of Scilly","LSIP","Total","2417","383","1692","948","245","5685"
201718,"Cumbria","LSIP","All other qualifications","61","116","185","140","56","558"
201718,"Cumbria","LSIP","Level 2","150","279","268","150","51","898"
201718,"Cumbria","LSIP","Level 3","1596","458","696","193","110","3053"
201718,"Cumbria","LSIP","Total","1807","853","1149","483","217","4509"
201819,"Cumbria","LSIP","All other qualifications","49","125","151","161","48","534"
201819,"Cumbria","LSIP","Level 2","176","254","296","131","34","891"
201819,"Cumbria","LSIP","Level 3","1356","362","586","175","77","2556"
201819,"Cumbria","LSIP","Total","1581","741","1033","467","159","3981"
201920,"Cumbria","LSIP","All other qualifications","73","151","139","155","37","555"
201920,"Cumbria","LSIP","Level 2","129","208","189","106","34","666"
201920,"Cumbria","LSIP","Level 3","1383","375","572","211","101","2642"
201920,"Cumbria","LSIP","Total","1585","734","900","472","172","3863"
202021,"Cumbria","LSIP","All other qualifications","85","86","130","156","35","492"
202021,"Cumbria","LSIP","Level 2","163","163","135","106","15","582"
202021,"Cumbria","LSIP","Level 3","1383","273","574","230","76","2536"
202021,"Cumbria","LSIP","Total","1631","522","839","492","126","3610"
201718,"Derbyshire and Nottinghamshire","LSIP","All other qualifications","506","477","709","800","348","2840"
201718,"Derbyshire and Nottinghamshire","LSIP","Level 2","766","624","1071","579","178","3218"
201718,"Derbyshire and Nottinghamshire","LSIP","Level 3","6779","1130","2689","889","405","11892"
201718,"Derbyshire and Nottinghamshire","LSIP","Total","8051","2231","4469","2268","931","17950"
201819,"Derbyshire and Nottinghamshire","LSIP","All other qualifications","501","461","694","779","264","2699"
201819,"Derbyshire and Nottinghamshire","LSIP","Level 2","661","685","1185","592","194","3317"
201819,"Derbyshire and Nottinghamshire","LSIP","Level 3","6040","895","2372","797","341","10445"
201819,"Derbyshire and Nottinghamshire","LSIP","Total","7202","2041","4251","2168","799","16461"
201920,"Derbyshire and Nottinghamshire","LSIP","All other qualifications","628","481","779","895","281","3064"
201920,"Derbyshire and Nottinghamshire","LSIP","Level 2","850","532","960","650","143","3135"
201920,"Derbyshire and Nottinghamshire","LSIP","Level 3","6286","845","2494","882","352","10859"
201920,"Derbyshire and Nottinghamshire","LSIP","Total","7764","1858","4233","2427","776","17058"
202021,"Derbyshire and Nottinghamshire","LSIP","All other qualifications","756","448","739","926","297","3166"
202021,"Derbyshire and Nottinghamshire","LSIP","Level 2","944","468","860","624","120","3016"
202021,"Derbyshire and Nottinghamshire","LSIP","Level 3","6706","609","2032","875","308","10530"
202021,"Derbyshire and Nottinghamshire","LSIP","Total","8406","1525","3631","2425","725","16712"
201718,"Dorset","LSIP","All other qualifications","169","267","529","417","182","1564"
201718,"Dorset","LSIP","Level 2","270","400","906","368","150","2094"
201718,"Dorset","LSIP","Level 3","5915","657","3671","959","428","11630"
201718,"Dorset","LSIP","Total","6354","1324","5106","1744","760","15288"
201819,"Dorset","LSIP","All other qualifications","212","184","526","392","178","1492"
201819,"Dorset","LSIP","Level 2","468","402","1253","473","146","2742"
201819,"Dorset","LSIP","Level 3","5502","583","3398","814","413","10710"
201819,"Dorset","LSIP","Total","6182","1169","5177","1679","737","14944"
201920,"Dorset","LSIP","All other qualifications","310","214","567","458","177","1726"
201920,"Dorset","LSIP","Level 2","397","323","844","364","116","2044"
201920,"Dorset","LSIP","Level 3","5951","573","3413","931","449","11317"
201920,"Dorset","LSIP","Total","6658","1110","4824","1753","742","15087"
202021,"Dorset","LSIP","All other qualifications","364","236","521","469","170","1760"
202021,"Dorset","LSIP","Level 2","590","255","702","372","112","2031"
202021,"Dorset","LSIP","Level 3","5878","385","2907","897","366","10433"
202021,"Dorset","LSIP","Total","6832","876","4130","1738","648","14224"
201718,"Enterprise M3 LEP (including all of Surrey)","LSIP","All other qualifications","160","142","354","278","194","1128"
201718,"Enterprise M3 LEP (including all of Surrey)","LSIP","Level 2","225","182","448","204","98","1157"
201718,"Enterprise M3 LEP (including all of Surrey)","LSIP","Level 3","4762","421","2665","700","332","8880"
201718,"Enterprise M3 LEP (including all of Surrey)","LSIP","Total","5147","745","3467","1182","624","11165"
201819,"Enterprise M3 LEP (including all of Surrey)","LSIP","All other qualifications","223","150","350","330","215","1268"
201819,"Enterprise M3 LEP (including all of Surrey)","LSIP","Level 2","492","224","732","315","142","1905"
201819,"Enterprise M3 LEP (including all of Surrey)","LSIP","Level 3","4476","374","2419","602","327","8198"
201819,"Enterprise M3 LEP (including all of Surrey)","LSIP","Total","5191","748","3501","1247","684","11371"
201920,"Enterprise M3 LEP (including all of Surrey)","LSIP","All other qualifications","234","164","389","315","186","1288"
201920,"Enterprise M3 LEP (including all of Surrey)","LSIP","Level 2","328","181","475","219","85","1288"
201920,"Enterprise M3 LEP (including all of Surrey)","LSIP","Level 3","4480","329","2506","636","333","8284"
201920,"Enterprise M3 LEP (including all of Surrey)","LSIP","Total","5042","674","3370","1170","604","10860"
202021,"Enterprise M3 LEP (including all of Surrey)","LSIP","All other qualifications","312","156","379","326","153","1326"
202021,"Enterprise M3 LEP (including all of Surrey)","LSIP","Level 2","388","114","311","196","92","1101"
202021,"Enterprise M3 LEP (including all of Surrey)","LSIP","Level 3","4415","180","1858","717","332","7502"
202021,"Enterprise M3 LEP (including all of Surrey)","LSIP","Total","5115","450","2548","1239","577","9929"
201718,"Essex, Southend-on-Sea and Thurrock","LSIP","All other qualifications","266","394","686","699","350","2395"
201718,"Essex, Southend-on-Sea and Thurrock","LSIP","Level 2","541","407","914","486","204","2552"
201718,"Essex, Southend-on-Sea and Thurrock","LSIP","Level 3","6740","1116","3726","1054","505","13141"
201718,"Essex, Southend-on-Sea and Thurrock","LSIP","Total","7547","1917","5326","2239","1059","18088"
201819,"Essex, Southend-on-Sea and Thurrock","LSIP","All other qualifications","274","353","700","663","302","2292"
201819,"Essex, Southend-on-Sea and Thurrock","LSIP","Level 2","619","412","1178","616","229","3054"
201819,"Essex, Southend-on-Sea and Thurrock","LSIP","Level 3","5987","991","3159","1002","376","11515"
201819,"Essex, Southend-on-Sea and Thurrock","LSIP","Total","6880","1756","5037","2281","907","16861"
201920,"Essex, Southend-on-Sea and Thurrock","LSIP","All other qualifications","271","373","759","729","310","2442"
201920,"Essex, Southend-on-Sea and Thurrock","LSIP","Level 2","429","344","878","543","168","2362"
201920,"Essex, Southend-on-Sea and Thurrock","LSIP","Level 3","6442","885","3409","1074","420","12230"
201920,"Essex, Southend-on-Sea and Thurrock","LSIP","Total","7142","1602","5046","2346","898","17034"
202021,"Essex, Southend-on-Sea and Thurrock","LSIP","All other qualifications","428","366","739","795","270","2598"
202021,"Essex, Southend-on-Sea and Thurrock","LSIP","Level 2","739","363","946","707","196","2951"
202021,"Essex, Southend-on-Sea and Thurrock","LSIP","Level 3","7392","660","3311","1384","448","13195"
202021,"Essex, Southend-on-Sea and Thurrock","LSIP","Total","8559","1389","4996","2886","914","18744"
201718,"Gloucestershire","LSIP","All other qualifications","100","98","190","143","63","594"
201718,"Gloucestershire","LSIP","Level 2","153","113","312","106","55","739"
201718,"Gloucestershire","LSIP","Level 3","2756","353","1478","362","212","5161"
201718,"Gloucestershire","LSIP","Total","3009","564","1980","611","330","6494"
201819,"Gloucestershire","LSIP","All other qualifications","117","108","212","127","60","624"
201819,"Gloucestershire","LSIP","Level 2","213","154","284","114","35","800"
201819,"Gloucestershire","LSIP","Level 3","2628","367","1477","374","181","5027"
201819,"Gloucestershire","LSIP","Total","2958","629","1973","615","276","6451"
201920,"Gloucestershire","LSIP","All other qualifications","170","93","202","143","48","656"
201920,"Gloucestershire","LSIP","Level 2","130","109","259","117","37","652"
201920,"Gloucestershire","LSIP","Level 3","2511","348","1435","401","195","4890"
201920,"Gloucestershire","LSIP","Total","2811","550","1896","661","280","6198"
202021,"Gloucestershire","LSIP","All other qualifications","141","115","197","192","46","691"
202021,"Gloucestershire","LSIP","Level 2","229","90","232","110","33","694"
202021,"Gloucestershire","LSIP","Level 3","2622","252","1324","461","191","4850"
202021,"Gloucestershire","LSIP","Total","2992","457","1753","763","270","6235"
201718,"Greater Lincolnshire","LSIP","All other qualifications","296","280","460","522","202","1760"
201718,"Greater Lincolnshire","LSIP","Level 2","461","339","657","378","115","1950"
201718,"Greater Lincolnshire","LSIP","Level 3","4420","645","1741","564","330","7700"
201718,"Greater Lincolnshire","LSIP","Total","5177","1264","2858","1464","647","11410"
201819,"Greater Lincolnshire","LSIP","All other qualifications","339","298","470","549","167","1823"
201819,"Greater Lincolnshire","LSIP","Level 2","742","476","906","505","120","2749"
201819,"Greater Lincolnshire","LSIP","Level 3","4102","619","1524","565","281","7091"
201819,"Greater Lincolnshire","LSIP","Total","5183","1393","2900","1619","568","11663"
201920,"Greater Lincolnshire","LSIP","All other qualifications","361","263","502","631","158","1915"
201920,"Greater Lincolnshire","LSIP","Level 2","496","395","683","475","108","2157"
201920,"Greater Lincolnshire","LSIP","Level 3","4498","548","1674","642","248","7610"
201920,"Greater Lincolnshire","LSIP","Total","5355","1206","2859","1748","514","11682"
202021,"Greater Lincolnshire","LSIP","All other qualifications","505","303","533","778","182","2301"
202021,"Greater Lincolnshire","LSIP","Level 2","798","306","751","611","116","2582"
202021,"Greater Lincolnshire","LSIP","Level 3","4710","427","1634","758","287","7816"
202021,"Greater Lincolnshire","LSIP","Total","6013","1036","2918","2147","585","12699"
201718,"Greater London","LSIP","All other qualifications","2488","874","2044","2865","2211","10482"
201718,"Greater London","LSIP","Level 2","3006","859","1913","1597","924","8299"
201718,"Greater London","LSIP","Level 3","38602","2225","8589","4617","2819","56852"
201718,"Greater London","LSIP","Total","44096","3958","12546","9079","5954","75633"
201819,"Greater London","LSIP","All other qualifications","2550","794","2144","2973","2046","10507"
201819,"Greater London","LSIP","Level 2","4953","888","2504","2162","1029","11536"
201819,"Greater London","LSIP","Level 3","37613","1988","8521","4424","2635","55181"
201819,"Greater London","LSIP","Total","45116","3670","13169","9559","5710","77224"
201920,"Greater London","LSIP","All other qualifications","2752","711","2141","3250","1827","10681"
201920,"Greater London","LSIP","Level 2","2923","681","1757","1784","793","7938"
201920,"Greater London","LSIP","Level 3","39970","1752","8957","4761","2682","58122"
201920,"Greater London","LSIP","Total","45645","3144","12855","9795","5302","76741"
202021,"Greater London","LSIP","All other qualifications","3647","685","1975","3451","1661","11419"
202021,"Greater London","LSIP","Level 2","5377","499","1523","1982","736","10117"
202021,"Greater London","LSIP","Level 3","42491","1150","6075","6162","2908","58786"
202021,"Greater London","LSIP","Total","51515","2334","9573","11595","5305","80322"
201718,"Greater Manchester","LSIP","All other qualifications","753","632","956","1304","617","4262"
201718,"Greater Manchester","LSIP","Level 2","1135","685","1329","865","323","4337"
201718,"Greater Manchester","LSIP","Level 3","11460","1554","4069","1651","767","19501"
201718,"Greater Manchester","LSIP","Total","13348","2871","6354","3820","1707","28100"
201819,"Greater Manchester","LSIP","All other qualifications","879","595","969","1336","547","4326"
201819,"Greater Manchester","LSIP","Level 2","2258","695","1698","1235","325","6211"
201819,"Greater Manchester","LSIP","Level 3","11104","1392","3589","1474","628","18187"
201819,"Greater Manchester","LSIP","Total","14241","2682","6256","4045","1500","28724"
201920,"Greater Manchester","LSIP","All other qualifications","806","573","1001","1392","566","4338"
201920,"Greater Manchester","LSIP","Level 2","1085","533","1075","920","244","3857"
201920,"Greater Manchester","LSIP","Level 3","11639","1253","3871","1820","672","19255"
201920,"Greater Manchester","LSIP","Total","13530","2359","5947","4132","1482","27450"
202021,"Greater Manchester","LSIP","All other qualifications","1513","561","989","1699","514","5276"
202021,"Greater Manchester","LSIP","Level 2","2652","505","1060","1215","234","5666"
202021,"Greater Manchester","LSIP","Level 3","12441","833","3236","2338","771","19619"
202021,"Greater Manchester","LSIP","Total","16606","1899","5285","5252","1519","30561"
201718,"Heart of the South-West","LSIP","All other qualifications","338","371","591","669","243","2212"
201718,"Heart of the South-West","LSIP","Level 2","526","606","1044","503","194","2873"
201718,"Heart of the South-West","LSIP","Level 3","5306","903","3351","948","386","10894"
201718,"Heart of the South-West","LSIP","Total","6170","1880","4986","2120","823","15979"
201819,"Heart of the South-West","LSIP","All other qualifications","354","364","612","665","204","2199"
201819,"Heart of the South-West","LSIP","Level 2","821","775","1400","668","192","3856"
201819,"Heart of the South-West","LSIP","Level 3","4933","787","3206","854","361","10141"
201819,"Heart of the South-West","LSIP","Total","6108","1926","5218","2187","757","16196"
201920,"Heart of the South-West","LSIP","All other qualifications","360","388","646","708","258","2360"
201920,"Heart of the South-West","LSIP","Level 2","498","590","1008","546","141","2783"
201920,"Heart of the South-West","LSIP","Level 3","4785","818","3115","972","412","10102"
201920,"Heart of the South-West","LSIP","Total","5643","1796","4769","2226","811","15245"
202021,"Heart of the South-West","LSIP","All other qualifications","475","391","604","706","198","2374"
202021,"Heart of the South-West","LSIP","Level 2","926","490","863","626","133","3038"
202021,"Heart of the South-West","LSIP","Level 3","5321","587","2988","1046","411","10353"
202021,"Heart of the South-West","LSIP","Total","6722","1468","4455","2378","742","15765"
201718,"Hertfordshire","LSIP","All other qualifications","280","201","459","416","185","1541"
201718,"Hertfordshire","LSIP","Level 2","496","229","590","277","110","1702"
201718,"Hertfordshire","LSIP","Level 3","6048","533","2367","642","343","9933"
201718,"Hertfordshire","LSIP","Total","6824","963","3416","1335","638","13176"
201819,"Hertfordshire","LSIP","All other qualifications","163","169","395","407","179","1313"
201819,"Hertfordshire","LSIP","Level 2","604","316","791","371","162","2244"
201819,"Hertfordshire","LSIP","Level 3","5895","491","2258","633","311","9588"
201819,"Hertfordshire","LSIP","Total","6662","976","3444","1411","652","13145"
201920,"Hertfordshire","LSIP","All other qualifications","311","188","422","455","183","1559"
201920,"Hertfordshire","LSIP","Level 2","395","233","659","333","125","1745"
201920,"Hertfordshire","LSIP","Level 3","6192","527","2483","756","334","10292"
201920,"Hertfordshire","LSIP","Total","6898","948","3564","1544","642","13596"
202021,"Hertfordshire","LSIP","All other qualifications","453","150","446","519","197","1765"
202021,"Hertfordshire","LSIP","Level 2","773","184","531","376","116","1980"
202021,"Hertfordshire","LSIP","Level 3","6635","317","2030","894","393","10269"
202021,"Hertfordshire","LSIP","Total","7861","651","3007","1789","706","14014"
201718,"Hull and East Yorkshire","LSIP","All other qualifications","90","194","290","342","123","1039"
201718,"Hull and East Yorkshire","LSIP","Level 2","202","195","369","269","92","1127"
201718,"Hull and East Yorkshire","LSIP","Level 3","2193","364","911","360","142","3970"
201718,"Hull and East Yorkshire","LSIP","Total","2485","753","1570","971","357","6136"
201819,"Hull and East Yorkshire","LSIP","All other qualifications","121","159","220","304","88","892"
201819,"Hull and East Yorkshire","LSIP","Level 2","266","213","422","347","79","1327"
201819,"Hull and East Yorkshire","LSIP","Level 3","1978","328","765","312","110","3493"
201819,"Hull and East Yorkshire","LSIP","Total","2365","700","1407","963","277","5712"
201920,"Hull and East Yorkshire","LSIP","All other qualifications","163","163","212","326","94","958"
201920,"Hull and East Yorkshire","LSIP","Level 2","226","156","298","267","45","992"
201920,"Hull and East Yorkshire","LSIP","Level 3","2050","349","836","365","133","3733"
201920,"Hull and East Yorkshire","LSIP","Total","2439","668","1346","958","272","5683"
202021,"Hull and East Yorkshire","LSIP","All other qualifications","270","192","219","323","84","1088"
202021,"Hull and East Yorkshire","LSIP","Level 2","379","113","249","260","41","1042"
202021,"Hull and East Yorkshire","LSIP","Level 3","2362","259","679","435","86","3821"
202021,"Hull and East Yorkshire","LSIP","Total","3011","564","1147","1018","211","5951"
201718,"Kent and Medway","LSIP","All other qualifications","334","375","706","838","459","2712"
201718,"Kent and Medway","LSIP","Level 2","657","377","1126","695","278","3133"
201718,"Kent and Medway","LSIP","Level 3","7339","839","3760","1167","592","13697"
201718,"Kent and Medway","LSIP","Total","8330","1591","5592","2700","1329","19542"
201819,"Kent and Medway","LSIP","All other qualifications","306","327","674","829","372","2508"
201819,"Kent and Medway","LSIP","Level 2","612","392","1109","634","260","3007"
201819,"Kent and Medway","LSIP","Level 3","6836","799","3257","990","504","12386"
201819,"Kent and Medway","LSIP","Total","7754","1518","5040","2453","1136","17901"
201920,"Kent and Medway","LSIP","All other qualifications","314","312","722","882","349","2579"
201920,"Kent and Medway","LSIP","Level 2","524","358","1000","658","248","2788"
201920,"Kent and Medway","LSIP","Level 3","6798","649","3416","1130","500","12493"
201920,"Kent and Medway","LSIP","Total","7636","1319","5138","2670","1097","17860"
202021,"Kent and Medway","LSIP","All other qualifications","494","310","791","1026","332","2953"
202021,"Kent and Medway","LSIP","Level 2","854","312","1065","833","247","3311"
202021,"Kent and Medway","LSIP","Level 3","7563","459","3023","1399","505","12949"
202021,"Kent and Medway","LSIP","Total","8911","1081","4879","3258","1084","19213"
201718,"Lancashire","LSIP","All other qualifications","411","349","426","712","293","2191"
201718,"Lancashire","LSIP","Level 2","610","373","606","414","139","2142"
201718,"Lancashire","LSIP","Level 3","6446","840","2240","855","382","10763"
201718,"Lancashire","LSIP","Total","7467","1562","3272","1981","814","15096"
201819,"Lancashire","LSIP","All other qualifications","443","329","459","751","295","2277"
201819,"Lancashire","LSIP","Level 2","856","467","827","560","165","2875"
201819,"Lancashire","LSIP","Level 3","5879","824","2031","716","312","9762"
201819,"Lancashire","LSIP","Total","7178","1620","3317","2027","772","14914"
201920,"Lancashire","LSIP","All other qualifications","393","383","513","826","313","2428"
201920,"Lancashire","LSIP","Level 2","395","319","573","487","104","1878"
201920,"Lancashire","LSIP","Level 3","6234","738","2186","840","356","10354"
201920,"Lancashire","LSIP","Total","7022","1440","3272","2153","773","14660"
202021,"Lancashire","LSIP","All other qualifications","673","366","537","956","235","2767"
202021,"Lancashire","LSIP","Level 2","991","331","570","574","113","2579"
202021,"Lancashire","LSIP","Level 3","6315","613","2111","1138","360","10537"
202021,"Lancashire","LSIP","Total","7979","1310","3218","2668","708","15883"
201718,"Leicester and Leicestershire","LSIP","All other qualifications","163","233","385","415","182","1378"
201718,"Leicester and Leicestershire","LSIP","Level 2","310","316","488","242","80","1436"
201718,"Leicester and Leicestershire","LSIP","Level 3","4160","547","1495","547","262","7011"
201718,"Leicester and Leicestershire","LSIP","Total","4633","1096","2368","1204","524","9825"
201819,"Leicester and Leicestershire","LSIP","All other qualifications","185","172","357","327","151","1192"
201819,"Leicester and Leicestershire","LSIP","Level 2","569","334","696","371","119","2089"
201819,"Leicester and Leicestershire","LSIP","Level 3","3987","449","1386","493","266","6581"
201819,"Leicester and Leicestershire","LSIP","Total","4741","955","2439","1191","536","9862"
201920,"Leicester and Leicestershire","LSIP","All other qualifications","212","170","379","369","173","1303"
201920,"Leicester and Leicestershire","LSIP","Level 2","263","261","456","280","94","1354"
201920,"Leicester and Leicestershire","LSIP","Level 3","4189","433","1442","565","292","6921"
201920,"Leicester and Leicestershire","LSIP","Total","4664","864","2277","1214","559","9578"
202021,"Leicester and Leicestershire","LSIP","All other qualifications","349","208","375","413","160","1505"
202021,"Leicester and Leicestershire","LSIP","Level 2","568","215","428","319","99","1629"
202021,"Leicester and Leicestershire","LSIP","Level 3","4258","280","1372","719","302","6931"
202021,"Leicester and Leicestershire","LSIP","Total","5175","703","2175","1451","561","10065"
201718,"Liverpool City Region","LSIP","All other qualifications","346","337","398","567","252","1900"
201718,"Liverpool City Region","LSIP","Level 2","763","384","694","482","145","2468"
201718,"Liverpool City Region","LSIP","Level 3","6337","741","2191","847","406","10522"
201718,"Liverpool City Region","LSIP","Total","7446","1462","3283","1896","803","14890"
201819,"Liverpool City Region","LSIP","All other qualifications","308","322","469","635","214","1948"
201819,"Liverpool City Region","LSIP","Level 2","869","437","775","621","147","2849"
201819,"Liverpool City Region","LSIP","Level 3","5638","589","1838","844","268","9177"
201819,"Liverpool City Region","LSIP","Total","6815","1348","3082","2100","629","13974"
201920,"Liverpool City Region","LSIP","All other qualifications","423","339","543","702","230","2237"
201920,"Liverpool City Region","LSIP","Level 2","781","361","731","569","134","2576"
201920,"Liverpool City Region","LSIP","Level 3","5608","592","1952","867","331","9350"
201920,"Liverpool City Region","LSIP","Total","6812","1292","3226","2138","695","14163"
202021,"Liverpool City Region","LSIP","All other qualifications","515","324","568","860","212","2479"
202021,"Liverpool City Region","LSIP","Level 2","924","275","621","602","108","2530"
202021,"Liverpool City Region","LSIP","Level 3","6116","360","1620","1051","258","9405"
202021,"Liverpool City Region","LSIP","Total","7555","959","2809","2513","578","14414"
<<<<<<< HEAD
201718,"Norfolk and Suffolk","LSIP","All other qualifications","300","222","492","547","205","1766"
201718,"Norfolk and Suffolk","LSIP","Level 2","342","326","815","367","147","1997"
201718,"Norfolk and Suffolk","LSIP","Level 3","3644","601","2351","664","286","7546"
201718,"Norfolk and Suffolk","LSIP","Total","4286","1149","3658","1578","638","11309"
201819,"Norfolk and Suffolk","LSIP","All other qualifications","207","210","445","545","171","1578"
201819,"Norfolk and Suffolk","LSIP","Level 2","497","395","1020","458","163","2533"
201819,"Norfolk and Suffolk","LSIP","Level 3","3318","556","2061","606","240","6781"
201819,"Norfolk and Suffolk","LSIP","Total","4022","1161","3526","1609","574","10892"
=======
201718,"Norfolk and Suffolk","LSIP","All other qualifications","402","306","663","703","273","2347"
201718,"Norfolk and Suffolk","LSIP","Level 2","540","449","1094","465","194","2742"
201718,"Norfolk and Suffolk","LSIP","Level 3","4870","784","3076","836","371","9937"
201718,"Norfolk and Suffolk","LSIP","Total","5812","1539","4833","2004","838","15026"
201819,"Norfolk and Suffolk","LSIP","All other qualifications","283","291","637","724","213","2148"
201819,"Norfolk and Suffolk","LSIP","Level 2","765","524","1343","626","215","3473"
201819,"Norfolk and Suffolk","LSIP","Level 3","4438","728","2714","796","330","9006"
201819,"Norfolk and Suffolk","LSIP","Total","5486","1543","4694","2146","758","14627"
>>>>>>> d231ffba6719ce99eeb75ba59dbf3d8e79efd608
201920,"Norfolk and Suffolk","LSIP","All other qualifications","496","296","695","730","217","2434"
201920,"Norfolk and Suffolk","LSIP","Level 2","568","433","1095","561","159","2816"
201920,"Norfolk and Suffolk","LSIP","Level 3","4568","726","2810","927","329","9360"
201920,"Norfolk and Suffolk","LSIP","Total","5632","1455","4600","2218","705","14610"
202021,"Norfolk and Suffolk","LSIP","All other qualifications","553","318","629","765","205","2470"
202021,"Norfolk and Suffolk","LSIP","Level 2","973","328","892","564","156","2913"
202021,"Norfolk and Suffolk","LSIP","Level 3","5119","486","2609","1000","309","9523"
202021,"Norfolk and Suffolk","LSIP","Total","6645","1132","4130","2329","670","14906"
<<<<<<< HEAD
201718,"Norfolk and Suffolk (Greater Anglia)","LSIP","All other qualifications","102","84","171","156","68","581"
201718,"Norfolk and Suffolk (Greater Anglia)","LSIP","Level 2","198","123","279","98","47","745"
201718,"Norfolk and Suffolk (Greater Anglia)","LSIP","Level 3","1226","183","725","172","85","2391"
201718,"Norfolk and Suffolk (Greater Anglia)","LSIP","Total","1526","390","1175","426","200","3717"
201819,"Norfolk and Suffolk (Greater Anglia)","LSIP","All other qualifications","76","81","192","179","42","570"
201819,"Norfolk and Suffolk (Greater Anglia)","LSIP","Level 2","268","129","323","168","52","940"
201819,"Norfolk and Suffolk (Greater Anglia)","LSIP","Level 3","1120","172","653","190","90","2225"
201819,"Norfolk and Suffolk (Greater Anglia)","LSIP","Total","1464","382","1168","537","184","3735"
=======
>>>>>>> d231ffba6719ce99eeb75ba59dbf3d8e79efd608
201718,"North East","LSIP","All other qualifications","217","423","339","583","261","1823"
201718,"North East","LSIP","Level 2","305","351","412","350","103","1521"
201718,"North East","LSIP","Level 3","3540","771","1135","577","265","6288"
201718,"North East","LSIP","Total","4062","1545","1886","1510","629","9632"
201819,"North East","LSIP","All other qualifications","302","382","387","684","269","2024"
201819,"North East","LSIP","Level 2","670","417","627","635","124","2473"
201819,"North East","LSIP","Level 3","3574","731","1086","540","174","6105"
201819,"North East","LSIP","Total","4546","1530","2100","1859","567","10602"
201920,"North East","LSIP","All other qualifications","292","355","380","735","235","1997"
201920,"North East","LSIP","Level 2","354","365","428","504","84","1735"
201920,"North East","LSIP","Level 3","3773","715","1188","697","178","6551"
201920,"North East","LSIP","Total","4419","1435","1996","1936","497","10283"
202021,"North East","LSIP","All other qualifications","473","305","411","800","253","2242"
202021,"North East","LSIP","Level 2","760","331","478","626","98","2293"
202021,"North East","LSIP","Level 3","4173","457","1119","822","236","6807"
202021,"North East","LSIP","Total","5406","1093","2008","2248","587","11342"
201718,"North of Tyne","LSIP","All other qualifications","214","263","342","677","270","1766"
201718,"North of Tyne","LSIP","Level 2","249","197","375","283","91","1195"
201718,"North of Tyne","LSIP","Level 3","3687","679","1224","551","206","6347"
201718,"North of Tyne","LSIP","Total","4150","1139","1941","1511","567","9308"
201819,"North of Tyne","LSIP","All other qualifications","311","233","378","635","244","1801"
201819,"North of Tyne","LSIP","Level 2","457","261","514","437","93","1762"
201819,"North of Tyne","LSIP","Level 3","3134","478","1081","455","164","5312"
201819,"North of Tyne","LSIP","Total","3902","972","1973","1527","501","8875"
201920,"North of Tyne","LSIP","All other qualifications","322","225","402","604","207","1760"
201920,"North of Tyne","LSIP","Level 2","507","236","439","411","86","1679"
201920,"North of Tyne","LSIP","Level 3","3394","472","1188","585","196","5835"
201920,"North of Tyne","LSIP","Total","4223","933","2029","1600","489","9274"
202021,"North of Tyne","LSIP","All other qualifications","385","243","358","720","190","1896"
202021,"North of Tyne","LSIP","Level 2","581","207","371","407","101","1667"
202021,"North of Tyne","LSIP","Level 3","3825","295","949","643","194","5906"
202021,"North of Tyne","LSIP","Total","4791","745","1678","1770","485","9469"
201718,"Oxfordshire","LSIP","All other qualifications","187","126","385","234","106","1038"
201718,"Oxfordshire","LSIP","Level 2","261","129","434","175","64","1063"
201718,"Oxfordshire","LSIP","Level 3","2534","349","1628","430","185","5126"
201718,"Oxfordshire","LSIP","Total","2982","604","2447","839","355","7227"
201819,"Oxfordshire","LSIP","All other qualifications","108","125","362","237","122","954"
201819,"Oxfordshire","LSIP","Level 2","205","131","634","223","81","1274"
201819,"Oxfordshire","LSIP","Level 3","2224","289","1557","342","177","4589"
201819,"Oxfordshire","LSIP","Total","2537","545","2553","802","380","6817"
201920,"Oxfordshire","LSIP","All other qualifications","149","111","409","257","129","1055"
201920,"Oxfordshire","LSIP","Level 2","203","140","593","246","93","1275"
201920,"Oxfordshire","LSIP","Level 3","2406","271","1634","419","189","4919"
201920,"Oxfordshire","LSIP","Total","2758","522","2636","922","411","7249"
202021,"Oxfordshire","LSIP","All other qualifications","296","139","435","296","178","1344"
202021,"Oxfordshire","LSIP","Level 2","656","155","605","396","109","1921"
202021,"Oxfordshire","LSIP","Level 3","2867","180","1634","546","234","5461"
202021,"Oxfordshire","LSIP","Total","3819","474","2674","1238","521","8726"
201718,"Solent","LSIP","All other qualifications","316","328","454","556","237","1891"
201718,"Solent","LSIP","Level 2","395","384","848","386","160","2173"
201718,"Solent","LSIP","Level 3","3992","663","2621","707","312","8295"
201718,"Solent","LSIP","Total","4703","1375","3923","1649","709","12359"
201819,"Solent","LSIP","All other qualifications","313","265","577","585","221","1961"
201819,"Solent","LSIP","Level 2","658","387","1061","483","154","2743"
201819,"Solent","LSIP","Level 3","3834","519","2259","573","321","7506"
201819,"Solent","LSIP","Total","4805","1171","3897","1641","696","12210"
201920,"Solent","LSIP","All other qualifications","313","259","549","567","199","1887"
201920,"Solent","LSIP","Level 2","337","355","654","402","115","1863"
201920,"Solent","LSIP","Level 3","3689","530","2386","687","304","7596"
201920,"Solent","LSIP","Total","4339","1144","3589","1656","618","11346"
202021,"Solent","LSIP","All other qualifications","549","250","559","628","214","2200"
202021,"Solent","LSIP","Level 2","797","261","665","466","131","2320"
202021,"Solent","LSIP","Level 3","4393","373","2210","825","345","8146"
202021,"Solent","LSIP","Total","5739","884","3434","1919","690","12666"
201718,"South East Midlands","LSIP","All other qualifications","475","335","757","650","316","2533"
201718,"South East Midlands","LSIP","Level 2","840","394","975","458","169","2836"
201718,"South East Midlands","LSIP","Level 3","6651","916","3034","879","377","11857"
201718,"South East Midlands","LSIP","Total","7966","1645","4766","1987","862","17226"
201819,"South East Midlands","LSIP","All other qualifications","432","358","777","675","289","2531"
201819,"South East Midlands","LSIP","Level 2","945","376","1053","475","170","3019"
201819,"South East Midlands","LSIP","Level 3","6105","761","2777","829","338","10810"
201819,"South East Midlands","LSIP","Total","7482","1495","4607","1979","797","16360"
201920,"South East Midlands","LSIP","All other qualifications","455","293","776","690","328","2542"
201920,"South East Midlands","LSIP","Level 2","895","305","1021","515","177","2913"
201920,"South East Midlands","LSIP","Level 3","6471","647","2885","900","339","11242"
201920,"South East Midlands","LSIP","Total","7821","1245","4682","2105","844","16697"
202021,"South East Midlands","LSIP","All other qualifications","434","302","695","682","225","2338"
202021,"South East Midlands","LSIP","Level 2","974","269","883","483","128","2737"
202021,"South East Midlands","LSIP","Level 3","6711","478","2623","1050","363","11225"
202021,"South East Midlands","LSIP","Total","8119","1049","4201","2215","716","16300"
201718,"South Yorkshire","LSIP","All other qualifications","310","386","486","621","292","2095"
201718,"South Yorkshire","LSIP","Level 2","525","420","784","482","165","2376"
201718,"South Yorkshire","LSIP","Level 3","4676","754","1889","705","325","8349"
201718,"South Yorkshire","LSIP","Total","5511","1560","3159","1808","782","12820"
201819,"South Yorkshire","LSIP","All other qualifications","330","332","550","665","246","2123"
201819,"South Yorkshire","LSIP","Level 2","758","427","1096","691","156","3128"
201819,"South Yorkshire","LSIP","Level 3","4325","655","1653","630","186","7449"
201819,"South Yorkshire","LSIP","Total","5413","1414","3299","1986","588","12700"
201920,"South Yorkshire","LSIP","All other qualifications","382","358","554","707","240","2241"
201920,"South Yorkshire","LSIP","Level 2","435","353","620","500","119","2027"
201920,"South Yorkshire","LSIP","Level 3","4709","593","1640","699","215","7856"
201920,"South Yorkshire","LSIP","Total","5526","1304","2814","1906","574","12124"
202021,"South Yorkshire","LSIP","All other qualifications","594","302","521","826","233","2476"
202021,"South Yorkshire","LSIP","Level 2","887","266","528","487","94","2262"
202021,"South Yorkshire","LSIP","Level 3","4907","342","1478","830","235","7792"
202021,"South Yorkshire","LSIP","Total","6388","910","2527","2143","562","12530"
201718,"Stoke-on-Trent and Staffordshire","LSIP","All other qualifications","220","216","433","470","158","1497"
201718,"Stoke-on-Trent and Staffordshire","LSIP","Level 2","479","323","582","250","86","1720"
201718,"Stoke-on-Trent and Staffordshire","LSIP","Level 3","3708","663","1589","493","166","6619"
201718,"Stoke-on-Trent and Staffordshire","LSIP","Total","4407","1202","2604","1213","410","9836"
201819,"Stoke-on-Trent and Staffordshire","LSIP","All other qualifications","189","228","401","405","144","1367"
201819,"Stoke-on-Trent and Staffordshire","LSIP","Level 2","574","318","611","350","79","1932"
201819,"Stoke-on-Trent and Staffordshire","LSIP","Level 3","3536","502","1525","452","188","6203"
201819,"Stoke-on-Trent and Staffordshire","LSIP","Total","4299","1048","2537","1207","411","9502"
201920,"Stoke-on-Trent and Staffordshire","LSIP","All other qualifications","242","205","417","411","132","1407"
201920,"Stoke-on-Trent and Staffordshire","LSIP","Level 2","370","269","541","328","95","1603"
201920,"Stoke-on-Trent and Staffordshire","LSIP","Level 3","3663","545","1518","530","193","6449"
201920,"Stoke-on-Trent and Staffordshire","LSIP","Total","4275","1019","2476","1269","420","9459"
202021,"Stoke-on-Trent and Staffordshire","LSIP","All other qualifications","343","208","347","415","136","1449"
202021,"Stoke-on-Trent and Staffordshire","LSIP","Level 2","596","216","501","310","78","1701"
202021,"Stoke-on-Trent and Staffordshire","LSIP","Level 3","3741","375","1431","633","156","6336"
202021,"Stoke-on-Trent and Staffordshire","LSIP","Total","4680","799","2279","1358","370","9486"
201718,"Swindon and Wiltshire","LSIP","All other qualifications","179","147","430","299","147","1202"
201718,"Swindon and Wiltshire","LSIP","Level 2","267","184","466","150","55","1122"
201718,"Swindon and Wiltshire","LSIP","Level 3","2194","324","1426","354","141","4439"
201718,"Swindon and Wiltshire","LSIP","Total","2640","655","2322","803","343","6763"
201819,"Swindon and Wiltshire","LSIP","All other qualifications","202","178","392","309","93","1174"
201819,"Swindon and Wiltshire","LSIP","Level 2","328","208","490","173","65","1264"
201819,"Swindon and Wiltshire","LSIP","Level 3","1968","268","1295","328","104","3963"
201819,"Swindon and Wiltshire","LSIP","Total","2498","654","2177","810","262","6401"
201920,"Swindon and Wiltshire","LSIP","All other qualifications","188","135","395","289","120","1127"
201920,"Swindon and Wiltshire","LSIP","Level 2","291","133","412","204","52","1092"
201920,"Swindon and Wiltshire","LSIP","Level 3","2024","218","1256","342","127","3967"
201920,"Swindon and Wiltshire","LSIP","Total","2503","486","2063","835","299","6186"
202021,"Swindon and Wiltshire","LSIP","All other qualifications","212","148","321","295","108","1084"
202021,"Swindon and Wiltshire","LSIP","Level 2","413","108","378","230","50","1179"
202021,"Swindon and Wiltshire","LSIP","Level 3","2290","146","1115","399","148","4098"
202021,"Swindon and Wiltshire","LSIP","Total","2915","402","1814","924","306","6361"
201718,"Tees Valley","LSIP","All other qualifications","114","221","188","382","145","1050"
201718,"Tees Valley","LSIP","Level 2","302","218","288","268","80","1156"
201718,"Tees Valley","LSIP","Level 3","3179","548","943","450","181","5301"
201718,"Tees Valley","LSIP","Total","3595","987","1419","1100","406","7507"
201819,"Tees Valley","LSIP","All other qualifications","135","200","227","428","129","1119"
201819,"Tees Valley","LSIP","Level 2","639","303","459","449","73","1923"
201819,"Tees Valley","LSIP","Level 3","2810","409","797","418","129","4563"
201819,"Tees Valley","LSIP","Total","3584","912","1483","1295","331","7605"
201920,"Tees Valley","LSIP","All other qualifications","214","278","270","434","85","1281"
201920,"Tees Valley","LSIP","Level 2","361","219","230","312","37","1159"
201920,"Tees Valley","LSIP","Level 3","2930","397","779","442","108","4656"
201920,"Tees Valley","LSIP","Total","3505","894","1279","1188","230","7096"
202021,"Tees Valley","LSIP","All other qualifications","251","269","237","536","103","1396"
202021,"Tees Valley","LSIP","Level 2","506","183","247","329","38","1303"
202021,"Tees Valley","LSIP","Level 3","3135","316","805","563","108","4927"
202021,"Tees Valley","LSIP","Total","3892","768","1289","1428","249","7626"
201718,"Thames Valley Berkshire","LSIP","All other qualifications","112","110","245","145","119","731"
201718,"Thames Valley Berkshire","LSIP","Level 2","203","157","333","160","75","928"
201718,"Thames Valley Berkshire","LSIP","Level 3","3495","406","1485","405","185","5976"
201718,"Thames Valley Berkshire","LSIP","Total","3810","673","2063","710","379","7635"
201819,"Thames Valley Berkshire","LSIP","All other qualifications","135","99","229","199","112","774"
201819,"Thames Valley Berkshire","LSIP","Level 2","229","147","438","174","96","1084"
201819,"Thames Valley Berkshire","LSIP","Level 3","3661","370","1484","426","230","6171"
201819,"Thames Valley Berkshire","LSIP","Total","4025","616","2151","799","438","8029"
201920,"Thames Valley Berkshire","LSIP","All other qualifications","157","107","255","210","119","848"
201920,"Thames Valley Berkshire","LSIP","Level 2","210","93","286","144","73","806"
201920,"Thames Valley Berkshire","LSIP","Level 3","3747","330","1639","428","201","6345"
201920,"Thames Valley Berkshire","LSIP","Total","4114","530","2180","782","393","7999"
202021,"Thames Valley Berkshire","LSIP","All other qualifications","196","95","255","234","125","905"
202021,"Thames Valley Berkshire","LSIP","Level 2","278","69","200","143","52","742"
202021,"Thames Valley Berkshire","LSIP","Level 3","3820","187","1270","497","258","6032"
202021,"Thames Valley Berkshire","LSIP","Total","4294","351","1725","874","435","7679"
201718,"The Marches","LSIP","All other qualifications","111","101","185","178","84","659"
201718,"The Marches","LSIP","Level 2","138","177","357","199","84","955"
201718,"The Marches","LSIP","Level 3","2476","366","1346","362","193","4743"
201718,"The Marches","LSIP","Total","2725","644","1888","739","361","6357"
201819,"The Marches","LSIP","All other qualifications","121","127","224","244","77","793"
201819,"The Marches","LSIP","Level 2","218","245","566","294","102","1425"
201819,"The Marches","LSIP","Level 3","2256","339","1316","365","174","4450"
201819,"The Marches","LSIP","Total","2595","711","2106","903","353","6668"
201920,"The Marches","LSIP","All other qualifications","138","144","240","215","71","808"
201920,"The Marches","LSIP","Level 2","236","170","350","230","68","1054"
201920,"The Marches","LSIP","Level 3","2511","338","1332","423","174","4778"
201920,"The Marches","LSIP","Total","2885","652","1922","868","313","6640"
202021,"The Marches","LSIP","All other qualifications","186","125","220","284","86","901"
202021,"The Marches","LSIP","Level 2","340","111","284","262","59","1056"
202021,"The Marches","LSIP","Level 3","2488","226","1148","433","167","4462"
202021,"The Marches","LSIP","Total","3014","462","1652","979","312","6419"
201718,"West Midlands and Warwickshire","LSIP","All other qualifications","1042","828","1391","1701","871","5833"
201718,"West Midlands and Warwickshire","LSIP","Level 2","1676","916","1622","1109","482","5805"
201718,"West Midlands and Warwickshire","LSIP","Level 3","16165","1845","5113","2360","1175","26658"
201718,"West Midlands and Warwickshire","LSIP","Total","18883","3589","8126","5170","2528","38296"
201819,"West Midlands and Warwickshire","LSIP","All other qualifications","1145","793","1352","1917","822","6029"
201819,"West Midlands and Warwickshire","LSIP","Level 2","2640","1002","2264","1571","557","8034"
201819,"West Midlands and Warwickshire","LSIP","Level 3","15298","1820","4530","2235","932","24815"
201819,"West Midlands and Warwickshire","LSIP","Total","19083","3615","8146","5723","2311","38878"
201920,"West Midlands and Warwickshire","LSIP","All other qualifications","1308","726","1458","2057","897","6446"
201920,"West Midlands and Warwickshire","LSIP","Level 2","2052","820","1637","1377","374","6260"
201920,"West Midlands and Warwickshire","LSIP","Level 3","16539","1543","4877","2453","943","26355"
201920,"West Midlands and Warwickshire","LSIP","Total","19899","3089","7972","5887","2214","39061"
202021,"West Midlands and Warwickshire","LSIP","All other qualifications","1895","703","1350","2394","784","7126"
202021,"West Midlands and Warwickshire","LSIP","Level 2","3242","700","1344","1667","349","7302"
202021,"West Midlands and Warwickshire","LSIP","Level 3","17036","1066","3981","3066","934","26083"
202021,"West Midlands and Warwickshire","LSIP","Total","22173","2469","6675","7127","2067","40511"
201718,"West of England and North Somerset","LSIP","All other qualifications","271","369","589","496","257","1982"
201718,"West of England and North Somerset","LSIP","Level 2","383","312","759","299","121","1874"
201718,"West of England and North Somerset","LSIP","Level 3","3567","611","2373","609","227","7387"
201718,"West of England and North Somerset","LSIP","Total","4221","1292","3721","1404","605","11243"
201819,"West of England and North Somerset","LSIP","All other qualifications","318","344","538","569","226","1995"
201819,"West of England and North Somerset","LSIP","Level 2","662","332","799","406","127","2326"
201819,"West of England and North Somerset","LSIP","Level 3","3279","565","2109","506","265","6724"
201819,"West of England and North Somerset","LSIP","Total","4259","1241","3446","1481","618","11045"
201920,"West of England and North Somerset","LSIP","All other qualifications","352","295","620","577","221","2065"
201920,"West of England and North Somerset","LSIP","Level 2","430","321","668","311","92","1822"
201920,"West of England and North Somerset","LSIP","Level 3","3478","474","2240","562","247","7001"
201920,"West of England and North Somerset","LSIP","Total","4260","1090","3528","1450","560","10888"
202021,"West of England and North Somerset","LSIP","All other qualifications","395","241","527","603","148","1914"
202021,"West of England and North Somerset","LSIP","Level 2","580","291","635","353","83","1942"
202021,"West of England and North Somerset","LSIP","Level 3","3771","319","1954","754","269","7067"
202021,"West of England and North Somerset","LSIP","Total","4746","851","3116","1710","500","10923"
201718,"West Yorkshire","LSIP","All other qualifications","618","475","716","1204","498","3511"
201718,"West Yorkshire","LSIP","Level 2","983","587","935","703","262","3470"
201718,"West Yorkshire","LSIP","Level 3","9661","1371","2987","1346","568","15933"
201718,"West Yorkshire","LSIP","Total","11262","2433","4638","3253","1328","22914"
201819,"West Yorkshire","LSIP","All other qualifications","541","417","716","1143","483","3300"
201819,"West Yorkshire","LSIP","Level 2","1266","686","1159","907","278","4296"
201819,"West Yorkshire","LSIP","Level 3","8524","1122","2680","1161","451","13938"
201819,"West Yorkshire","LSIP","Total","10331","2225","4555","3211","1212","21534"
201920,"West Yorkshire","LSIP","All other qualifications","624","491","706","1128","424","3373"
201920,"West Yorkshire","LSIP","Level 2","1021","547","939","902","208","3617"
201920,"West Yorkshire","LSIP","Level 3","8932","1104","2780","1315","509","14640"
201920,"West Yorkshire","LSIP","Total","10577","2142","4425","3345","1141","21630"
202021,"West Yorkshire","LSIP","All other qualifications","899","490","708","1281","405","3783"
202021,"West Yorkshire","LSIP","Level 2","1766","450","812","1104","263","4395"
202021,"West Yorkshire","LSIP","Level 3","9924","790","2352","1603","496","15165"
202021,"West Yorkshire","LSIP","Total","12589","1730","3872","3988","1164","23343"
201718,"Worcestershire","LSIP","All other qualifications","38","94","184","167","65","548"
201718,"Worcestershire","LSIP","Level 2","42","94","141","76","23","376"
201718,"Worcestershire","LSIP","Level 3","1751","340","803","250","99","3243"
201718,"Worcestershire","LSIP","Total","1831","528","1128","493","187","4167"
201819,"Worcestershire","LSIP","All other qualifications","41","114","193","178","69","595"
201819,"Worcestershire","LSIP","Level 2","109","164","337","157","43","810"
201819,"Worcestershire","LSIP","Level 3","1518","276","790","200","101","2885"
201819,"Worcestershire","LSIP","Total","1668","554","1320","535","213","4290"
201920,"Worcestershire","LSIP","All other qualifications","51","83","167","198","53","552"
201920,"Worcestershire","LSIP","Level 2","67","117","200","116","29","529"
201920,"Worcestershire","LSIP","Level 3","1422","239","808","228","115","2812"
201920,"Worcestershire","LSIP","Total","1540","439","1175","542","197","3893"
202021,"Worcestershire","LSIP","All other qualifications","98","91","166","171","53","579"
202021,"Worcestershire","LSIP","Level 2","158","68","212","116","37","591"
202021,"Worcestershire","LSIP","Level 3","1766","145","682","277","91","2961"
202021,"Worcestershire","LSIP","Total","2022","304","1060","564","181","4131"
201718,"York and North Yorkshire","LSIP","All other qualifications","84","137","230","223","84","758"
201718,"York and North Yorkshire","LSIP","Level 2","130","234","474","192","93","1123"
201718,"York and North Yorkshire","LSIP","Level 3","3485","502","1829","472","254","6542"
201718,"York and North Yorkshire","LSIP","Total","3699","873","2533","887","431","8423"
201819,"York and North Yorkshire","LSIP","All other qualifications","76","103","185","216","70","650"
201819,"York and North Yorkshire","LSIP","Level 2","267","252","632","276","97","1524"
201819,"York and North Yorkshire","LSIP","Level 3","3125","414","1479","415","206","5639"
201819,"York and North Yorkshire","LSIP","Total","3468","769","2296","907","373","7813"
201920,"York and North Yorkshire","LSIP","All other qualifications","93","147","262","256","85","843"
201920,"York and North Yorkshire","LSIP","Level 2","154","181","426","226","81","1068"
201920,"York and North Yorkshire","LSIP","Level 3","3274","382","1580","497","219","5952"
201920,"York and North Yorkshire","LSIP","Total","3521","710","2268","979","385","7863"
202021,"York and North Yorkshire","LSIP","All other qualifications","175","141","267","306","75","964"
202021,"York and North Yorkshire","LSIP","Level 2","291","191","355","236","41","1114"
202021,"York and North Yorkshire","LSIP","Level 3","3559","290","1439","538","269","6095"
202021,"York and North Yorkshire","LSIP","Total","4025","622","2061","1080","385","8173"
201718,"Cambridgeshire and Peterborough","MCA","All other qualifications","187","155","401","330","199","1272"
201718,"Cambridgeshire and Peterborough","MCA","Level 2","390","144","438","186","95","1253"
201718,"Cambridgeshire and Peterborough","MCA","Level 3","2851","314","1743","409","221","5538"
201718,"Cambridgeshire and Peterborough","MCA","Total","3428","613","2582","925","515","8063"
201819,"Cambridgeshire and Peterborough","MCA","All other qualifications","182","168","433","355","181","1319"
201819,"Cambridgeshire and Peterborough","MCA","Level 2","289","198","574","221","142","1424"
201819,"Cambridgeshire and Peterborough","MCA","Level 3","2809","310","1591","409","218","5337"
201819,"Cambridgeshire and Peterborough","MCA","Total","3280","676","2598","985","541","8080"
201920,"Cambridgeshire and Peterborough","MCA","All other qualifications","241","154","424","344","156","1319"
201920,"Cambridgeshire and Peterborough","MCA","Level 2","268","128","455","206","69","1126"
201920,"Cambridgeshire and Peterborough","MCA","Level 3","3060","266","1739","442","238","5745"
201920,"Cambridgeshire and Peterborough","MCA","Total","3569","548","2618","992","463","8190"
202021,"Cambridgeshire and Peterborough","MCA","All other qualifications","277","145","384","368","130","1304"
202021,"Cambridgeshire and Peterborough","MCA","Level 2","362","84","346","176","68","1036"
202021,"Cambridgeshire and Peterborough","MCA","Level 3","3380","192","1427","545","264","5808"
202021,"Cambridgeshire and Peterborough","MCA","Total","4019","421","2157","1089","462","8148"
201718,"Greater Manchester","MCA","All other qualifications","753","632","956","1304","617","4262"
201718,"Greater Manchester","MCA","Level 2","1135","685","1329","865","323","4337"
201718,"Greater Manchester","MCA","Level 3","11460","1554","4069","1651","767","19501"
201718,"Greater Manchester","MCA","Total","13348","2871","6354","3820","1707","28100"
201819,"Greater Manchester","MCA","All other qualifications","879","595","969","1336","547","4326"
201819,"Greater Manchester","MCA","Level 2","2258","695","1698","1235","325","6211"
201819,"Greater Manchester","MCA","Level 3","11104","1392","3589","1474","628","18187"
201819,"Greater Manchester","MCA","Total","14241","2682","6256","4045","1500","28724"
201920,"Greater Manchester","MCA","All other qualifications","806","573","1001","1392","566","4338"
201920,"Greater Manchester","MCA","Level 2","1085","533","1075","920","244","3857"
201920,"Greater Manchester","MCA","Level 3","11639","1253","3871","1820","672","19255"
201920,"Greater Manchester","MCA","Total","13530","2359","5947","4132","1482","27450"
202021,"Greater Manchester","MCA","All other qualifications","1513","561","989","1699","514","5276"
202021,"Greater Manchester","MCA","Level 2","2652","505","1060","1215","234","5666"
202021,"Greater Manchester","MCA","Level 3","12441","833","3236","2338","771","19619"
202021,"Greater Manchester","MCA","Total","16606","1899","5285","5252","1519","30561"
201718,"Liverpool City Region","MCA","All other qualifications","346","337","398","567","252","1900"
201718,"Liverpool City Region","MCA","Level 2","763","384","694","482","145","2468"
201718,"Liverpool City Region","MCA","Level 3","6337","741","2191","847","406","10522"
201718,"Liverpool City Region","MCA","Total","7446","1462","3283","1896","803","14890"
201819,"Liverpool City Region","MCA","All other qualifications","308","322","469","635","214","1948"
201819,"Liverpool City Region","MCA","Level 2","869","437","775","621","147","2849"
201819,"Liverpool City Region","MCA","Level 3","5638","589","1838","844","268","9177"
201819,"Liverpool City Region","MCA","Total","6815","1348","3082","2100","629","13974"
201920,"Liverpool City Region","MCA","All other qualifications","423","339","543","702","230","2237"
201920,"Liverpool City Region","MCA","Level 2","781","361","731","569","134","2576"
201920,"Liverpool City Region","MCA","Level 3","5608","592","1952","867","331","9350"
201920,"Liverpool City Region","MCA","Total","6812","1292","3226","2138","695","14163"
202021,"Liverpool City Region","MCA","All other qualifications","515","324","568","860","212","2479"
202021,"Liverpool City Region","MCA","Level 2","924","275","621","602","108","2530"
202021,"Liverpool City Region","MCA","Level 3","6116","360","1620","1051","258","9405"
202021,"Liverpool City Region","MCA","Total","7555","959","2809","2513","578","14414"
201718,"North East","MCA","All other qualifications","217","423","339","583","261","1823"
201718,"North East","MCA","Level 2","305","351","412","350","103","1521"
201718,"North East","MCA","Level 3","3540","771","1135","577","265","6288"
201718,"North East","MCA","Total","4062","1545","1886","1510","629","9632"
201819,"North East","MCA","All other qualifications","302","382","387","684","269","2024"
201819,"North East","MCA","Level 2","670","417","627","635","124","2473"
201819,"North East","MCA","Level 3","3574","731","1086","540","174","6105"
201819,"North East","MCA","Total","4546","1530","2100","1859","567","10602"
201920,"North East","MCA","All other qualifications","292","355","380","735","235","1997"
201920,"North East","MCA","Level 2","354","365","428","504","84","1735"
201920,"North East","MCA","Level 3","3773","715","1188","697","178","6551"
201920,"North East","MCA","Total","4419","1435","1996","1936","497","10283"
202021,"North East","MCA","All other qualifications","473","305","411","800","253","2242"
202021,"North East","MCA","Level 2","760","331","478","626","98","2293"
202021,"North East","MCA","Level 3","4173","457","1119","822","236","6807"
202021,"North East","MCA","Total","5406","1093","2008","2248","587","11342"
201718,"North of Tyne","MCA","All other qualifications","214","263","342","677","270","1766"
201718,"North of Tyne","MCA","Level 2","249","197","375","283","91","1195"
201718,"North of Tyne","MCA","Level 3","3687","679","1224","551","206","6347"
201718,"North of Tyne","MCA","Total","4150","1139","1941","1511","567","9308"
201819,"North of Tyne","MCA","All other qualifications","311","233","378","635","244","1801"
201819,"North of Tyne","MCA","Level 2","457","261","514","437","93","1762"
201819,"North of Tyne","MCA","Level 3","3134","478","1081","455","164","5312"
201819,"North of Tyne","MCA","Total","3902","972","1973","1527","501","8875"
201920,"North of Tyne","MCA","All other qualifications","322","225","402","604","207","1760"
201920,"North of Tyne","MCA","Level 2","507","236","439","411","86","1679"
201920,"North of Tyne","MCA","Level 3","3394","472","1188","585","196","5835"
201920,"North of Tyne","MCA","Total","4223","933","2029","1600","489","9274"
202021,"North of Tyne","MCA","All other qualifications","385","243","358","720","190","1896"
202021,"North of Tyne","MCA","Level 2","581","207","371","407","101","1667"
202021,"North of Tyne","MCA","Level 3","3825","295","949","643","194","5906"
202021,"North of Tyne","MCA","Total","4791","745","1678","1770","485","9469"
201718,"South Yorkshire","MCA","All other qualifications","310","386","486","621","292","2095"
201718,"South Yorkshire","MCA","Level 2","525","420","784","482","165","2376"
201718,"South Yorkshire","MCA","Level 3","4676","754","1889","705","325","8349"
201718,"South Yorkshire","MCA","Total","5511","1560","3159","1808","782","12820"
201819,"South Yorkshire","MCA","All other qualifications","330","332","550","665","246","2123"
201819,"South Yorkshire","MCA","Level 2","758","427","1096","691","156","3128"
201819,"South Yorkshire","MCA","Level 3","4325","655","1653","630","186","7449"
201819,"South Yorkshire","MCA","Total","5413","1414","3299","1986","588","12700"
201920,"South Yorkshire","MCA","All other qualifications","382","358","554","707","240","2241"
201920,"South Yorkshire","MCA","Level 2","435","353","620","500","119","2027"
201920,"South Yorkshire","MCA","Level 3","4709","593","1640","699","215","7856"
201920,"South Yorkshire","MCA","Total","5526","1304","2814","1906","574","12124"
202021,"South Yorkshire","MCA","All other qualifications","594","302","521","826","233","2476"
202021,"South Yorkshire","MCA","Level 2","887","266","528","487","94","2262"
202021,"South Yorkshire","MCA","Level 3","4907","342","1478","830","235","7792"
202021,"South Yorkshire","MCA","Total","6388","910","2527","2143","562","12530"
201718,"Tees Valley","MCA","All other qualifications","114","221","188","382","145","1050"
201718,"Tees Valley","MCA","Level 2","302","218","288","268","80","1156"
201718,"Tees Valley","MCA","Level 3","3179","548","943","450","181","5301"
201718,"Tees Valley","MCA","Total","3595","987","1419","1100","406","7507"
201819,"Tees Valley","MCA","All other qualifications","135","200","227","428","129","1119"
201819,"Tees Valley","MCA","Level 2","639","303","459","449","73","1923"
201819,"Tees Valley","MCA","Level 3","2810","409","797","418","129","4563"
201819,"Tees Valley","MCA","Total","3584","912","1483","1295","331","7605"
201920,"Tees Valley","MCA","All other qualifications","214","278","270","434","85","1281"
201920,"Tees Valley","MCA","Level 2","361","219","230","312","37","1159"
201920,"Tees Valley","MCA","Level 3","2930","397","779","442","108","4656"
201920,"Tees Valley","MCA","Total","3505","894","1279","1188","230","7096"
202021,"Tees Valley","MCA","All other qualifications","251","269","237","536","103","1396"
202021,"Tees Valley","MCA","Level 2","506","183","247","329","38","1303"
202021,"Tees Valley","MCA","Level 3","3135","316","805","563","108","4927"
202021,"Tees Valley","MCA","Total","3892","768","1289","1428","249","7626"
201718,"West Midlands","MCA","All other qualifications","927","691","1102","1479","785","4984"
201718,"West Midlands","MCA","Level 2","1398","719","1236","948","414","4715"
201718,"West Midlands","MCA","Level 3","13602","1487","3921","2038","1017","22065"
201718,"West Midlands","MCA","Total","15927","2897","6259","4465","2216","31764"
201819,"West Midlands","MCA","All other qualifications","961","620","1012","1607","717","4917"
201819,"West Midlands","MCA","Level 2","2093","785","1660","1305","447","6290"
201819,"West Midlands","MCA","Level 3","12796","1491","3334","1930","797","20348"
201819,"West Midlands","MCA","Total","15850","2896","6006","4842","1961","31555"
201920,"West Midlands","MCA","All other qualifications","1148","536","1095","1699","788","5266"
201920,"West Midlands","MCA","Level 2","1777","645","1235","1199","309","5165"
201920,"West Midlands","MCA","Level 3","14000","1265","3803","2130","817","22015"
201920,"West Midlands","MCA","Total","16925","2446","6133","5028","1914","32446"
202021,"West Midlands","MCA","All other qualifications","1615","551","1003","1930","668","5767"
202021,"West Midlands","MCA","Level 2","2867","543","1010","1427","291","6138"
202021,"West Midlands","MCA","Level 3","14314","856","3011","2687","819","21687"
202021,"West Midlands","MCA","Total","18796","1950","5024","6044","1778","33592"
201718,"West of England","MCA","All other qualifications","226","251","464","320","180","1441"
201718,"West of England","MCA","Level 2","258","258","608","220","98","1442"
201718,"West of England","MCA","Level 3","2792","506","1947","477","182","5904"
201718,"West of England","MCA","Total","3276","1015","3019","1017","460","8787"
201819,"West of England","MCA","All other qualifications","249","226","418","381","168","1442"
201819,"West of England","MCA","Level 2","461","249","622","304","104","1740"
201819,"West of England","MCA","Level 3","2593","455","1720","429","223","5420"
201819,"West of England","MCA","Total","3303","930","2760","1114","495","8602"
201920,"West of England","MCA","All other qualifications","287","219","485","377","175","1543"
201920,"West of England","MCA","Level 2","297","233","531","235","70","1366"
201920,"West of England","MCA","Level 3","2775","384","1822","465","200","5646"
201920,"West of England","MCA","Total","3359","836","2838","1077","445","8555"
202021,"West of England","MCA","All other qualifications","312","182","413","421","119","1447"
202021,"West of England","MCA","Level 2","427","196","505","268","56","1452"
202021,"West of England","MCA","Level 3","3060","274","1541","627","235","5737"
202021,"West of England","MCA","Total","3799","652","2459","1316","410","8636"
201718,"West Yorkshire","MCA","All other qualifications","618","475","716","1204","498","3511"
201718,"West Yorkshire","MCA","Level 2","983","587","935","703","262","3470"
201718,"West Yorkshire","MCA","Level 3","9661","1371","2987","1346","568","15933"
201718,"West Yorkshire","MCA","Total","11262","2433","4638","3253","1328","22914"
201819,"West Yorkshire","MCA","All other qualifications","541","417","716","1143","483","3300"
201819,"West Yorkshire","MCA","Level 2","1266","686","1159","907","278","4296"
201819,"West Yorkshire","MCA","Level 3","8524","1122","2680","1161","451","13938"
201819,"West Yorkshire","MCA","Total","10331","2225","4555","3211","1212","21534"
201920,"West Yorkshire","MCA","All other qualifications","624","491","706","1128","424","3373"
201920,"West Yorkshire","MCA","Level 2","1021","547","939","902","208","3617"
201920,"West Yorkshire","MCA","Level 3","8932","1104","2780","1315","509","14640"
201920,"West Yorkshire","MCA","Total","10577","2142","4425","3345","1141","21630"
202021,"West Yorkshire","MCA","All other qualifications","899","490","708","1281","405","3783"
202021,"West Yorkshire","MCA","Level 2","1766","450","812","1104","263","4395"
202021,"West Yorkshire","MCA","Level 3","9924","790","2352","1603","496","15165"
202021,"West Yorkshire","MCA","Total","12589","1730","3872","3988","1164","23343"
