"time_period","area","geographic_level","Sustained Education","Sustained Apprenticeships","Sustained Employment","Not Recorded as a sustained destination","Unknown","Total"
201516,"England","COUNTRY","468143","25967","14985","27639","3864","540598"
201617,"England","COUNTRY","455810","25432","15832","26397","4195","527666"
201718,"England","COUNTRY","446374","22485","16302","25286","4264","514711"
201819,"England","COUNTRY","444039","21241","16166","24972","4514","510932"
201920,"England","COUNTRY","461819","19758","16441","26377","4952","529347"
202021,"England","COUNTRY","491764","13413","13016","26258","6183","550634"
201516,"County Durham","LADU","4143","298","128","348","21","4938"
201617,"County Durham","LADU","4067","301","121","288","34","4811"
201718,"County Durham","LADU","3693","284","130","332","24","4463"
201819,"County Durham","LADU","3792","233","113","302","24","4464"
201920,"County Durham","LADU","3945","227","138","295","35","4640"
202021,"County Durham","LADU","4119","183","157","356","34","4849"
201516,"Darlington","LADU","981","71","35","69","2","1158"
201617,"Darlington","LADU","945","62","30","70","4","1111"
201718,"Darlington","LADU","891","36","35","61","11","1034"
201819,"Darlington","LADU","912","52","36","70","6","1076"
201920,"Darlington","LADU","954","60","53","61","4","1132"
202021,"Darlington","LADU","1024","25","24","59","5","1137"
201516,"Gateshead","LADU","1646","139","72","127","6","1990"
201617,"Gateshead","LADU","1586","99","57","102","12","1856"
201718,"Gateshead","LADU","1557","94","75","106","17","1849"
201819,"Gateshead","LADU","1519","132","63","99","12","1825"
201920,"Gateshead","LADU","1568","69","35","100","9","1781"
202021,"Gateshead","LADU","1653","51","60","101","11","1876"
201516,"Hartlepool","LADU","911","63","20","72","5","1071"
201617,"Hartlepool","LADU","855","91","29","68","10","1053"
201718,"Hartlepool","LADU","796","69","26","61","4","956"
201819,"Hartlepool","LADU","838","62","15","69","11","995"
201920,"Hartlepool","LADU","815","48","32","78","2","975"
202021,"Hartlepool","LADU","901","34","24","53","6","1018"
201516,"Middlesbrough","LADU","1094","72","36","129","11","1342"
201617,"Middlesbrough","LADU","1144","75","50","131","16","1416"
201718,"Middlesbrough","LADU","1100","48","66","114","9","1337"
201819,"Middlesbrough","LADU","1046","56","58","128","10","1298"
201920,"Middlesbrough","LADU","1066","42","49","131","12","1300"
202021,"Middlesbrough","LADU","1241","28","44","139","26","1478"
201516,"Newcastle upon Tyne","LADU","1859","119","90","167","32","2267"
201617,"Newcastle upon Tyne","LADU","1961","109","93","145","28","2336"
201718,"Newcastle upon Tyne","LADU","1866","118","118","181","22","2305"
201819,"Newcastle upon Tyne","LADU","1974","92","99","191","31","2387"
201920,"Newcastle upon Tyne","LADU","1954","70","91","198","22","2335"
202021,"Newcastle upon Tyne","LADU","2163","46","65","164","39","2477"
201516,"North Tyneside","LADU","1717","130","62","84","8","2001"
201617,"North Tyneside","LADU","1574","122","81","114","8","1899"
201718,"North Tyneside","LADU","1635","80","78","109","13","1915"
201819,"North Tyneside","LADU","1538","95","86","106","11","1836"
201920,"North Tyneside","LADU","1667","101","72","114","6","1960"
202021,"North Tyneside","LADU","1654","66","50","98","24","1892"
201516,"Northumberland","LADU","2875","230","105","201","6","3417"
201617,"Northumberland","LADU","2571","207","132","203","16","3129"
201718,"Northumberland","LADU","2511","214","120","193","23","3061"
201819,"Northumberland","LADU","2537","161","103","172","12","2985"
201920,"Northumberland","LADU","2404","222","114","183","15","2938"
202021,"Northumberland","LADU","2624","111","134","168","21","3058"
201516,"Redcar and Cleveland","LADU","1403","96","43","121","4","1667"
201617,"Redcar and Cleveland","LADU","1342","77","37","113","9","1578"
201718,"Redcar and Cleveland","LADU","1291","92","53","100","8","1544"
201819,"Redcar and Cleveland","LADU","1233","84","65","98","6","1486"
201920,"Redcar and Cleveland","LADU","1280","77","42","107","7","1513"
202021,"Redcar and Cleveland","LADU","1325","51","60","122","8","1566"
201516,"South Tyneside","LADU","1261","126","63","88","3","1541"
201617,"South Tyneside","LADU","1192","115","69","96","8","1480"
201718,"South Tyneside","LADU","1157","99","78","93","10","1437"
201819,"South Tyneside","LADU","1165","81","68","84","9","1407"
201920,"South Tyneside","LADU","1224","101","51","122","6","1504"
202021,"South Tyneside","LADU","1342","53","63","119","11","1588"
201516,"Stockton-on-Tees","LADU","1719","130","66","152","7","2074"
201617,"Stockton-on-Tees","LADU","1611","97","63","156","8","1935"
201718,"Stockton-on-Tees","LADU","1557","99","59","124","8","1847"
201819,"Stockton-on-Tees","LADU","1573","88","41","154","10","1866"
201920,"Stockton-on-Tees","LADU","1686","77","70","132","9","1974"
202021,"Stockton-on-Tees","LADU","1683","66","68","139","8","1964"
201516,"Sunderland","LADU","2306","242","123","213","7","2891"
201617,"Sunderland","LADU","2273","242","107","143","5","2770"
201718,"Sunderland","LADU","2139","191","142","206","15","2693"
201819,"Sunderland","LADU","2032","194","97","200","18","2541"
201920,"Sunderland","LADU","2180","188","119","207","18","2712"
202021,"Sunderland","LADU","2310","105","98","203","17","2733"
201516,"Allerdale","LADU","924","112","45","67","9","1157"
201617,"Allerdale","LADU","930","109","53","60","4","1156"
201718,"Allerdale","LADU","889","112","60","47","4","1112"
201819,"Allerdale","LADU","869","108","54","48","8","1087"
201920,"Allerdale","LADU","888","100","48","53","2","1091"
202021,"Allerdale","LADU","931","68","37","44","15","1095"
201516,"Barrow-in-Furness","LADU","610","106","22","34","4","776"
201617,"Barrow-in-Furness","LADU","545","124","34","41","3","747"
201718,"Barrow-in-Furness","LADU","536","112","28","29","2","707"
201819,"Barrow-in-Furness","LADU","485","88","26","45","2","646"
201920,"Barrow-in-Furness","LADU","476","95","18","34","5","628"
202021,"Barrow-in-Furness","LADU","482","86","44","44","3","659"
201516,"Blackburn with Darwen","LADU","1493","85","28","108","15","1729"
201617,"Blackburn with Darwen","LADU","1489","106","51","72","12","1730"
201718,"Blackburn with Darwen","LADU","1462","118","44","94","5","1723"
201819,"Blackburn with Darwen","LADU","1534","108","57","96","14","1809"
201920,"Blackburn with Darwen","LADU","1627","63","57","81","17","1845"
202021,"Blackburn with Darwen","LADU","1675","67","51","120","23","1936"
201516,"Blackpool","LADU","1098","74","66","127","7","1372"
201617,"Blackpool","LADU","1034","87","68","104","4","1297"
201718,"Blackpool","LADU","911","65","47","125","10","1158"
201819,"Blackpool","LADU","895","51","57","97","13","1113"
201920,"Blackpool","LADU","926","41","67","88","5","1127"
202021,"Blackpool","LADU","974","40","48","145","17","1224"
201516,"Bolton","LADU","2582","134","95","167","25","3003"
201617,"Bolton","LADU","2467","127","105","158","23","2880"
201718,"Bolton","LADU","2511","110","100","188","13","2922"
201819,"Bolton","LADU","2578","111","65","144","30","2928"
201920,"Bolton","LADU","2517","119","106","213","24","2979"
202021,"Bolton","LADU","2795","76","99","193","25","3188"
201516,"Burnley","LADU","702","71","45","74","12","904"
201617,"Burnley","LADU","641","51","21","74","10","797"
201718,"Burnley","LADU","682","71","20","71","6","850"
201819,"Burnley","LADU","653","56","48","72","8","837"
201920,"Burnley","LADU","670","54","32","65","20","841"
202021,"Burnley","LADU","758","34","33","94","12","931"
201516,"Bury","LADU","1800","85","75","122","9","2091"
201617,"Bury","LADU","1789","70","55","106","11","2031"
201718,"Bury","LADU","1816","73","72","127","6","2094"
201819,"Bury","LADU","1805","81","82","117","9","2094"
201920,"Bury","LADU","1792","81","80","128","22","2103"
202021,"Bury","LADU","1893","53","62","119","13","2140"
201516,"Carlisle","LADU","757","106","59","51","7","980"
201617,"Carlisle","LADU","764","120","51","48","4","987"
201718,"Carlisle","LADU","764","105","64","54","6","993"
201819,"Carlisle","LADU","683","106","47","37","8","881"
201920,"Carlisle","LADU","795","90","54","49","6","994"
202021,"Carlisle","LADU","881","64","52","53","5","1055"
201516,"Cheshire East","LADU","3376","213","110","158","16","3873"
201617,"Cheshire East","LADU","3249","186","102","162","18","3717"
201718,"Cheshire East","LADU","3136","183","109","106","18","3552"
201819,"Cheshire East","LADU","3114","141","91","122","18","3486"
201920,"Cheshire East","LADU","3286","135","110","138","21","3690"
202021,"Cheshire East","LADU","3409","108","102","114","23","3756"
201516,"Cheshire West and Chester","LADU","2985","184","111","179","42","3501"
201617,"Cheshire West and Chester","LADU","2791","193","143","184","34","3345"
201718,"Cheshire West and Chester","LADU","2706","153","159","171","57","3246"
201819,"Cheshire West and Chester","LADU","2743","112","163","164","36","3218"
201920,"Cheshire West and Chester","LADU","2861","110","163","177","52","3363"
202021,"Cheshire West and Chester","LADU","3030","96","100","155","63","3444"
201516,"Chorley","LADU","1109","92","57","65","7","1330"
201617,"Chorley","LADU","1109","107","45","50","5","1316"
201718,"Chorley","LADU","1069","97","57","68","8","1299"
201819,"Chorley","LADU","1065","82","53","58","5","1263"
201920,"Chorley","LADU","1106","72","46","57","5","1286"
202021,"Chorley","LADU","1220","58","39","79","6","1402"
201516,"Copeland","LADU","517","77","7","30","1","632"
201617,"Copeland","LADU","426","61","15","27","2","531"
201718,"Copeland","LADU","399","50","13","24","1","487"
201819,"Copeland","LADU","393","52","27","17","3","492"
201920,"Copeland","LADU","422","46","28","33","2","531"
202021,"Copeland","LADU","464","60","17","24","3","568"
201516,"Eden","LADU","435","53","27","19","2","536"
201617,"Eden","LADU","471","59","25","11","1","567"
201718,"Eden","LADU","405","55","14","18","0","492"
201819,"Eden","LADU","407","41","15","9","1","473"
201920,"Eden","LADU","403","52","38","20","3","516"
202021,"Eden","LADU","464","30","29","17","3","543"
201516,"Fylde","LADU","545","38","23","21","0","627"
201617,"Fylde","LADU","506","39","13","26","1","585"
201718,"Fylde","LADU","512","49","28","27","2","618"
201819,"Fylde","LADU","488","34","25","27","5","579"
201920,"Fylde","LADU","500","35","29","28","4","596"
202021,"Fylde","LADU","574","29","15","20","9","647"
201516,"Halton","LADU","1221","73","33","69","3","1399"
201617,"Halton","LADU","1134","77","39","91","5","1346"
201718,"Halton","LADU","1170","80","42","68","5","1365"
201819,"Halton","LADU","1089","67","58","82","4","1300"
201920,"Halton","LADU","1162","46","42","79","4","1333"
202021,"Halton","LADU","1239","50","42","74","8","1413"
201516,"Hyndburn","LADU","747","68","31","55","11","912"
201617,"Hyndburn","LADU","712","110","37","56","6","921"
201718,"Hyndburn","LADU","722","65","34","58","6","885"
201819,"Hyndburn","LADU","693","70","32","50","12","857"
201920,"Hyndburn","LADU","702","70","29","62","7","870"
202021,"Hyndburn","LADU","720","63","34","56","13","886"
201516,"Knowsley","LADU","881","72","53","165","9","1180"
201617,"Knowsley","LADU","815","70","57","144","14","1100"
201718,"Knowsley","LADU","724","43","47","112","5","931"
201819,"Knowsley","LADU","674","44","45","108","6","877"
201920,"Knowsley","LADU","712","48","62","107","13","942"
202021,"Knowsley","LADU","784","33","37","120","12","986"
201516,"Lancaster","LADU","1162","73","37","62","9","1343"
201617,"Lancaster","LADU","1093","80","40","55","12","1280"
201718,"Lancaster","LADU","1071","79","38","41","11","1240"
201819,"Lancaster","LADU","973","65","33","52","15","1138"
201920,"Lancaster","LADU","1042","74","38","56","19","1229"
202021,"Lancaster","LADU","1040","42","43","50","14","1189"
201516,"Liverpool","LADU","3983","248","134","301","35","4701"
201617,"Liverpool","LADU","3828","191","149","287","44","4499"
201718,"Liverpool","LADU","3702","153","170","289","24","4338"
201819,"Liverpool","LADU","3664","158","166","301","35","4324"
201920,"Liverpool","LADU","3889","173","138","338","41","4579"
202021,"Liverpool","LADU","4175","87","99","305","54","4720"
201516,"Manchester","LADU","3815","161","127","434","51","4588"
201617,"Manchester","LADU","3858","129","181","350","75","4593"
201718,"Manchester","LADU","3761","124","171","330","64","4450"
201819,"Manchester","LADU","3970","111","145","342","61","4629"
201920,"Manchester","LADU","4129","96","145","417","76","4863"
202021,"Manchester","LADU","4733","68","83","324","106","5314"
201516,"Oldham","LADU","2437","131","95","193","26","2882"
201617,"Oldham","LADU","2391","152","91","207","20","2861"
201718,"Oldham","LADU","2464","113","103","170","21","2871"
201819,"Oldham","LADU","2453","111","108","195","23","2890"
201920,"Oldham","LADU","2492","119","98","187","33","2929"
202021,"Oldham","LADU","2657","83","77","201","31","3049"
201516,"Pendle","LADU","754","52","20","42","10","878"
201617,"Pendle","LADU","678","55","20","59","12","824"
201718,"Pendle","LADU","747","45","28","50","11","881"
201819,"Pendle","LADU","747","32","20","45","14","858"
201920,"Pendle","LADU","706","38","29","45","8","826"
202021,"Pendle","LADU","814","29","25","47","10","925"
201516,"Preston","LADU","950","71","36","85","6","1148"
201617,"Preston","LADU","911","69","36","83","9","1108"
201718,"Preston","LADU","952","60","53","71","12","1148"
201819,"Preston","LADU","891","49","49","71","8","1068"
201920,"Preston","LADU","968","61","54","89","17","1189"
202021,"Preston","LADU","1064","50","44","77","24","1259"
201516,"Ribble Valley","LADU","771","73","26","38","4","912"
201617,"Ribble Valley","LADU","729","86","31","33","5","884"
201718,"Ribble Valley","LADU","682","94","45","42","3","866"
201819,"Ribble Valley","LADU","695","77","29","29","6","836"
201920,"Ribble Valley","LADU","701","88","39","25","3","856"
202021,"Ribble Valley","LADU","718","71","37","45","3","874"
201516,"Rochdale","LADU","1954","103","77","154","18","2306"
201617,"Rochdale","LADU","1912","96","88","168","10","2274"
201718,"Rochdale","LADU","1832","89","78","182","8","2189"
201819,"Rochdale","LADU","1846","105","77","145","10","2183"
201920,"Rochdale","LADU","1954","105","81","135","11","2286"
202021,"Rochdale","LADU","2174","56","74","138","18","2460"
201516,"Rossendale","LADU","733","50","11","39","5","838"
201617,"Rossendale","LADU","716","39","21","53","3","832"
201718,"Rossendale","LADU","681","50","20","45","2","798"
201819,"Rossendale","LADU","696","55","23","34","7","815"
201920,"Rossendale","LADU","716","47","29","43","5","840"
202021,"Rossendale","LADU","736","28","10","33","6","813"
201516,"Salford","LADU","1606","127","110","196","22","2061"
201617,"Salford","LADU","1571","138","132","150","18","2009"
201718,"Salford","LADU","1540","102","154","175","17","1988"
201819,"Salford","LADU","1631","97","117","161","17","2023"
201920,"Salford","LADU","1639","69","127","172","33","2040"
202021,"Salford","LADU","1854","65","76","185","33","2213"
201516,"Sefton","LADU","2626","172","98","161","11","3068"
201617,"Sefton","LADU","2539","130","113","216","17","3015"
201718,"Sefton","LADU","2441","131","124","207","20","2923"
201819,"Sefton","LADU","2390","112","112","167","21","2802"
201920,"Sefton","LADU","2456","121","87","166","20","2850"
202021,"Sefton","LADU","2457","99","84","192","25","2857"
201516,"South Lakeland","LADU","1035","89","30","36","4","1194"
201617,"South Lakeland","LADU","930","111","35","24","12","1112"
201718,"South Lakeland","LADU","928","92","26","19","7","1072"
201819,"South Lakeland","LADU","922","98","39","19","4","1082"
201920,"South Lakeland","LADU","978","72","38","33","12","1133"
202021,"South Lakeland","LADU","999","87","41","21","6","1154"
201516,"South Ribble","LADU","1234","122","52","84","8","1500"
201617,"South Ribble","LADU","1118","142","46","67","7","1380"
201718,"South Ribble","LADU","1170","120","44","52","5","1391"
201819,"South Ribble","LADU","1091","115","65","59","10","1340"
201920,"South Ribble","LADU","1142","110","59","76","7","1394"
202021,"South Ribble","LADU","1280","69","54","80","7","1490"
201516,"St. Helens","LADU","1524","92","63","108","6","1793"
201617,"St. Helens","LADU","1479","78","64","95","8","1724"
201718,"St. Helens","LADU","1377","85","87","97","11","1657"
201819,"St. Helens","LADU","1400","76","87","126","10","1699"
201920,"St. Helens","LADU","1442","80","73","117","8","1720"
202021,"St. Helens","LADU","1591","55","78","127","14","1865"
201516,"Stockport","LADU","2312","176","70","166","14","2738"
201617,"Stockport","LADU","2330","188","77","152","14","2761"
201718,"Stockport","LADU","2195","194","72","119","15","2595"
201819,"Stockport","LADU","2168","126","90","109","13","2506"
201920,"Stockport","LADU","2199","113","99","158","24","2593"
202021,"Stockport","LADU","2452","64","79","128","14","2737"
201516,"Tameside","LADU","2102","139","121","170","9","2541"
201617,"Tameside","LADU","2048","127","85","182","17","2459"
201718,"Tameside","LADU","2000","121","79","169","11","2380"
201819,"Tameside","LADU","2099","107","80","168","17","2471"
201920,"Tameside","LADU","2060","100","99","175","14","2448"
202021,"Tameside","LADU","2258","81","89","171","24","2623"
201516,"Trafford","LADU","2507","108","62","112","14","2803"
201617,"Trafford","LADU","2425","92","83","87","11","2698"
201718,"Trafford","LADU","2378","82","83","97","14","2654"
201819,"Trafford","LADU","2506","100","64","103","15","2788"
201920,"Trafford","LADU","2591","92","76","96","14","2869"
202021,"Trafford","LADU","2764","49","49","80","30","2972"
201516,"Warrington","LADU","2088","146","74","90","6","2404"
201617,"Warrington","LADU","2026","128","70","99","7","2330"
201718,"Warrington","LADU","1971","108","67","95","7","2248"
201819,"Warrington","LADU","2052","90","65","108","11","2326"
201920,"Warrington","LADU","1978","90","77","100","12","2257"
202021,"Warrington","LADU","2164","43","68","104","11","2390"
201516,"West Lancashire","LADU","1012","80","31","73","4","1200"
201617,"West Lancashire","LADU","928","59","29","52","10","1078"
201718,"West Lancashire","LADU","895","78","25","46","9","1053"
201819,"West Lancashire","LADU","897","47","38","58","2","1042"
201920,"West Lancashire","LADU","892","50","44","47","12","1045"
202021,"West Lancashire","LADU","919","29","27","61","6","1042"
201516,"Wigan","LADU","2850","321","125","203","17","3516"
201617,"Wigan","LADU","2768","244","147","179","17","3355"
201718,"Wigan","LADU","2741","232","148","161","8","3290"
201819,"Wigan","LADU","2725","183","104","140","15","3167"
201920,"Wigan","LADU","2777","210","129","178","7","3301"
202021,"Wigan","LADU","2971","145","131","164","9","3420"
201516,"Wirral","LADU","3040","132","89","168","15","3444"
201617,"Wirral","LADU","2923","136","95","150","23","3327"
201718,"Wirral","LADU","2861","122","117","135","25","3260"
201819,"Wirral","LADU","2796","123","98","126","32","3175"
201920,"Wirral","LADU","2948","77","96","161","21","3303"
202021,"Wirral","LADU","3072","70","77","158","31","3408"
201516,"Wyre","LADU","918","70","57","69","7","1121"
201617,"Wyre","LADU","949","100","53","42","5","1149"
201718,"Wyre","LADU","877","65","50","67","4","1063"
201819,"Wyre","LADU","858","63","45","47","3","1016"
201920,"Wyre","LADU","929","79","55","68","7","1138"
202021,"Wyre","LADU","1020","55","41","65","4","1185"
201516,"Barnsley","LADU","1786","232","77","132","8","2235"
201617,"Barnsley","LADU","1682","147","69","130","22","2050"
201718,"Barnsley","LADU","1711","132","82","118","27","2070"
201819,"Barnsley","LADU","1611","140","94","112","18","1975"
201920,"Barnsley","LADU","1718","123","87","114","14","2056"
202021,"Barnsley","LADU","1854","99","115","160","31","2259"
201516,"Bradford","LADU","4965","234","150","366","94","5809"
201617,"Bradford","LADU","4899","249","163","398","84","5793"
201718,"Bradford","LADU","4877","203","162","381","88","5711"
201819,"Bradford","LADU","4924","233","190","440","70","5857"
201920,"Bradford","LADU","5134","213","195","362","76","5980"
202021,"Bradford","LADU","5438","147","148","420","139","6292"
201516,"Calderdale","LADU","2232","157","51","113","12","2565"
201617,"Calderdale","LADU","2183","155","62","96","9","2505"
201718,"Calderdale","LADU","2084","166","55","141","10","2456"
201819,"Calderdale","LADU","2066","129","71","106","22","2394"
201920,"Calderdale","LADU","2188","129","72","131","11","2531"
202021,"Calderdale","LADU","2297","92","63","135","18","2605"
201516,"Craven","LADU","657","64","18","19","1","759"
201617,"Craven","LADU","667","61","11","16","5","760"
201718,"Craven","LADU","659","46","9","19","3","736"
201819,"Craven","LADU","625","57","15","19","8","724"
201920,"Craven","LADU","610","55","15","19","7","706"
202021,"Craven","LADU","650","46","9","14","3","722"
201516,"Doncaster","LADU","2622","238","129","213","15","3217"
201617,"Doncaster","LADU","2409","205","151","197","15","2977"
201718,"Doncaster","LADU","2413","182","167","160","20","2942"
201819,"Doncaster","LADU","2329","171","148","176","31","2855"
201920,"Doncaster","LADU","2399","161","153","221","20","2954"
202021,"Doncaster","LADU","2533","92","128","207","45","3005"
201516,"East Riding of Yorkshire","LADU","3162","281","73","149","16","3681"
201617,"East Riding of Yorkshire","LADU","2855","255","74","120","17","3321"
201718,"East Riding of Yorkshire","LADU","2876","243","96","111","14","3340"
201819,"East Riding of Yorkshire","LADU","2702","216","89","105","18","3130"
201920,"East Riding of Yorkshire","LADU","2654","202","80","120","17","3073"
202021,"East Riding of Yorkshire","LADU","2781","166","86","129","24","3186"
201516,"Hambleton","LADU","827","63","26","36","3","955"
201617,"Hambleton","LADU","743","56","24","25","10","858"
201718,"Hambleton","LADU","719","51","35","30","1","836"
201819,"Hambleton","LADU","641","60","22","26","6","755"
201920,"Hambleton","LADU","632","59","41","33","5","770"
202021,"Hambleton","LADU","634","38","35","30","9","746"
201516,"Harrogate","LADU","1481","88","48","47","10","1674"
201617,"Harrogate","LADU","1503","70","31","41","12","1657"
201718,"Harrogate","LADU","1416","59","47","37","8","1567"
201819,"Harrogate","LADU","1522","59","57","39","10","1687"
201920,"Harrogate","LADU","1552","47","60","53","12","1724"
202021,"Harrogate","LADU","1609","41","48","41","13","1752"
201516,"Kingston upon Hull, City of","LADU","1789","201","72","191","14","2267"
201617,"Kingston upon Hull, City of","LADU","1693","225","95","177","19","2209"
201718,"Kingston upon Hull, City of","LADU","1723","145","87","210","22","2187"
201819,"Kingston upon Hull, City of","LADU","1828","159","93","160","13","2253"
201920,"Kingston upon Hull, City of","LADU","1866","164","97","158","13","2298"
202021,"Kingston upon Hull, City of","LADU","2172","112","100","196","26","2606"
201516,"Kirklees","LADU","3902","304","84","210","22","4522"
201617,"Kirklees","LADU","3830","237","114","259","23","4463"
201718,"Kirklees","LADU","3695","259","126","205","21","4306"
201819,"Kirklees","LADU","3766","254","122","239","28","4409"
201920,"Kirklees","LADU","3991","240","124","242","28","4625"
202021,"Kirklees","LADU","4241","203","126","271","39","4880"
201516,"Leeds","LADU","6441","398","249","552","102","7742"
201617,"Leeds","LADU","6170","374","230","479","117","7370"
201718,"Leeds","LADU","6155","313","218","526","123","7335"
201819,"Leeds","LADU","6297","379","210","479","138","7503"
201920,"Leeds","LADU","6332","316","246","461","116","7471"
202021,"Leeds","LADU","7038","211","176","473","170","8068"
201516,"North East Lincolnshire","LADU","1516","98","31","129","3","1777"
201617,"North East Lincolnshire","LADU","1325","74","37","129","8","1573"
201718,"North East Lincolnshire","LADU","1339","90","42","91","5","1567"
201819,"North East Lincolnshire","LADU","1287","100","57","78","2","1524"
201920,"North East Lincolnshire","LADU","1333","89","60","100","6","1588"
202021,"North East Lincolnshire","LADU","1489","58","54","104","10","1715"
201516,"North Lincolnshire","LADU","1485","119","42","117","9","1772"
201617,"North Lincolnshire","LADU","1560","124","35","111","5","1835"
201718,"North Lincolnshire","LADU","1475","97","49","90","10","1721"
201819,"North Lincolnshire","LADU","1414","108","35","88","8","1653"
201920,"North Lincolnshire","LADU","1384","94","60","94","13","1645"
202021,"North Lincolnshire","LADU","1650","67","46","122","15","1900"
201516,"Richmondshire","LADU","433","29","30","29","1","522"
201617,"Richmondshire","LADU","427","22","14","22","4","489"
201718,"Richmondshire","LADU","417","32","22","25","5","501"
201819,"Richmondshire","LADU","411","26","22","20","5","484"
201920,"Richmondshire","LADU","442","22","22","18","4","508"
202021,"Richmondshire","LADU","413","27","28","17","3","488"
201516,"Rotherham","LADU","2648","239","131","216","17","3251"
201617,"Rotherham","LADU","2708","199","158","200","18","3283"
201718,"Rotherham","LADU","2410","171","170","200","9","2960"
201819,"Rotherham","LADU","2513","173","157","216","32","3091"
201920,"Rotherham","LADU","2473","189","154","236","17","3069"
202021,"Rotherham","LADU","2609","103","170","210","36","3128"
201516,"Ryedale","LADU","420","44","12","17","2","495"
201617,"Ryedale","LADU","404","36","20","16","2","478"
201718,"Ryedale","LADU","394","40","19","18","3","474"
201819,"Ryedale","LADU","376","28","30","9","4","447"
201920,"Ryedale","LADU","410","29","22","20","7","488"
202021,"Ryedale","LADU","475","34","24","19","3","555"
201516,"Scarborough","LADU","884","50","36","57","10","1037"
201617,"Scarborough","LADU","845","71","32","67","2","1017"
201718,"Scarborough","LADU","732","43","33","50","2","860"
201819,"Scarborough","LADU","760","59","48","69","7","943"
201920,"Scarborough","LADU","738","57","79","80","5","959"
202021,"Scarborough","LADU","787","39","53","39","9","927"
201516,"Selby","LADU","814","53","20","30","2","919"
201617,"Selby","LADU","758","35","19","34","7","853"
201718,"Selby","LADU","745","50","28","34","5","862"
201819,"Selby","LADU","731","41","25","41","6","844"
201920,"Selby","LADU","791","37","32","33","5","898"
202021,"Selby","LADU","794","31","18","34","13","890"
201516,"Sheffield","LADU","4352","332","163","297","32","5176"
201617,"Sheffield","LADU","4293","334","158","321","30","5136"
201718,"Sheffield","LADU","4138","297","175","343","29","4982"
201819,"Sheffield","LADU","4155","279","158","276","28","4896"
201920,"Sheffield","LADU","4338","239","141","344","35","5097"
202021,"Sheffield","LADU","4701","168","136","373","51","5429"
201516,"Wakefield","LADU","3134","217","91","265","15","3722"
201617,"Wakefield","LADU","2986","243","113","231","14","3587"
201718,"Wakefield","LADU","2870","151","116","202","19","3358"
201819,"Wakefield","LADU","2826","185","126","199","13","3349"
201920,"Wakefield","LADU","2916","149","114","211","26","3416"
202021,"Wakefield","LADU","3165","121","128","204","29","3647"
201516,"York","LADU","1504","86","48","56","8","1702"
201617,"York","LADU","1349","96","57","53","7","1562"
201718,"York","LADU","1364","97","49","73","9","1592"
201819,"York","LADU","1373","92","64","66","8","1603"
201920,"York","LADU","1480","57","58","85","3","1683"
202021,"York","LADU","1546","73","48","62","5","1734"
201516,"Amber Valley","LADU","1167","112","53","63","4","1399"
201617,"Amber Valley","LADU","1050","119","59","82","9","1319"
201718,"Amber Valley","LADU","1028","94","61","44","6","1233"
201819,"Amber Valley","LADU","1010","101","59","63","7","1240"
201920,"Amber Valley","LADU","1036","90","43","61","2","1232"
202021,"Amber Valley","LADU","1076","53","42","66","8","1245"
201516,"Ashfield","LADU","1101","84","53","89","13","1340"
201617,"Ashfield","LADU","977","113","55","93","11","1249"
201718,"Ashfield","LADU","921","83","62","76","6","1148"
201819,"Ashfield","LADU","969","103","67","73","6","1218"
201920,"Ashfield","LADU","1009","86","69","73","10","1247"
202021,"Ashfield","LADU","1113","71","56","69","10","1319"
201516,"Bassetlaw","LADU","970","85","38","57","10","1160"
201617,"Bassetlaw","LADU","918","86","46","53","6","1109"
201718,"Bassetlaw","LADU","841","56","36","48","5","986"
201819,"Bassetlaw","LADU","872","63","45","48","5","1033"
201920,"Bassetlaw","LADU","935","70","40","41","6","1092"
202021,"Bassetlaw","LADU","975","45","41","51","10","1122"
201516,"Blaby","LADU","306","25","10","15","1","357"
201617,"Blaby","LADU","395","40","22","30","0","487"
201718,"Blaby","LADU","556","78","41","45","2","722"
201819,"Blaby","LADU","490","55","28","36","0","609"
201920,"Blaby","LADU","472","26","30","49","1","578"
202021,"Blaby","LADU","524","18","16","37","7","602"
201516,"Bolsover","LADU","646","61","37","57","2","803"
201617,"Bolsover","LADU","578","68","27","59","4","736"
201718,"Bolsover","LADU","597","70","32","54","3","756"
201819,"Bolsover","LADU","565","57","50","49","4","725"
201920,"Bolsover","LADU","623","52","35","49","4","763"
202021,"Bolsover","LADU","585","26","26","60","8","705"
201516,"Boston","LADU","551","30","14","25","3","623"
201617,"Boston","LADU","590","36","8","26","1","661"
201718,"Boston","LADU","567","27","12","23","5","634"
201819,"Boston","LADU","536","16","6","25","5","588"
201920,"Boston","LADU","586","29","7","17","7","646"
202021,"Boston","LADU","609","18","6","21","15","669"
201516,"Broxtowe","LADU","766","75","28","60","7","936"
201617,"Broxtowe","LADU","754","65","33","48","7","907"
201718,"Broxtowe","LADU","733","48","37","39","8","865"
201819,"Broxtowe","LADU","747","51","32","31","7","868"
201920,"Broxtowe","LADU","787","54","31","29","6","907"
202021,"Broxtowe","LADU","831","31","22","42","13","939"
201516,"Charnwood","LADU","1619","104","46","76","7","1852"
201617,"Charnwood","LADU","1507","119","47","90","10","1773"
201718,"Charnwood","LADU","1500","100","63","83","6","1752"
201819,"Charnwood","LADU","1438","76","56","90","11","1671"
201920,"Charnwood","LADU","1489","79","45","90","11","1714"
202021,"Charnwood","LADU","1524","44","39","84","18","1709"
201516,"Chesterfield","LADU","1088","67","36","83","1","1275"
201617,"Chesterfield","LADU","1032","67","53","75","5","1232"
201718,"Chesterfield","LADU","917","80","41","60","6","1104"
201819,"Chesterfield","LADU","864","76","35","73","5","1053"
201920,"Chesterfield","LADU","951","68","33","48","4","1104"
202021,"Chesterfield","LADU","1018","35","37","77","6","1173"
201516,"Corby","LADU","650","38","30","38","6","762"
201617,"Corby","LADU","635","34","41","45","5","760"
201718,"Corby","LADU","641","29","28","48","10","756"
201819,"Corby","LADU","677","35","27","38","5","782"
201920,"Corby","LADU","644","33","26","34","5","742"
202021,"Corby","LADU","698","16","29","37","12","792"
201516,"Daventry","LADU","685","40","33","52","4","814"
201617,"Daventry","LADU","669","50","33","49","5","806"
201718,"Daventry","LADU","609","45","24","35","4","717"
201819,"Daventry","LADU","622","33","26","36","5","722"
201920,"Daventry","LADU","623","27","23","33","7","713"
202021,"Daventry","LADU","616","13","19","37","5","690"
201516,"Derby","LADU","2296","216","114","196","14","2836"
201617,"Derby","LADU","2185","207","99","187","30","2708"
201718,"Derby","LADU","2141","165","122","217","20","2665"
201819,"Derby","LADU","2161","186","108","190","21","2666"
201920,"Derby","LADU","2268","145","134","181","27","2755"
202021,"Derby","LADU","2414","114","121","185","41","2875"
201516,"Derbyshire Dales","LADU","723","55","26","22","1","827"
201617,"Derbyshire Dales","LADU","681","44","21","16","8","770"
201718,"Derbyshire Dales","LADU","632","57","22","15","6","732"
201819,"Derbyshire Dales","LADU","608","52","28","27","4","719"
201920,"Derbyshire Dales","LADU","630","45","23","22","5","725"
202021,"Derbyshire Dales","LADU","662","34","23","24","3","746"
201516,"East Lindsey","LADU","1270","75","28","73","12","1458"
201617,"East Lindsey","LADU","1121","61","40","64","9","1295"
201718,"East Lindsey","LADU","1098","48","29","67","13","1255"
201819,"East Lindsey","LADU","985","49","41","68","16","1159"
201920,"East Lindsey","LADU","1091","55","44","59","11","1260"
202021,"East Lindsey","LADU","1088","32","29","56","7","1212"
201516,"East Northamptonshire","LADU","730","51","19","47","2","849"
201617,"East Northamptonshire","LADU","703","51","39","52","6","851"
201718,"East Northamptonshire","LADU","629","38","40","22","4","733"
201819,"East Northamptonshire","LADU","626","45","23","28","4","726"
201920,"East Northamptonshire","LADU","654","26","45","40","7","772"
202021,"East Northamptonshire","LADU","713","21","17","27","8","786"
201516,"Erewash","LADU","856","108","32","54","9","1059"
201617,"Erewash","LADU","798","91","50","68","9","1016"
201718,"Erewash","LADU","782","88","43","44","11","968"
201819,"Erewash","LADU","780","87","59","58","11","995"
201920,"Erewash","LADU","770","68","40","69","15","962"
202021,"Erewash","LADU","829","59","53","81","16","1038"
201516,"Gedling","LADU","1169","80","41","65","21","1376"
201617,"Gedling","LADU","1080","91","28","78","10","1287"
201718,"Gedling","LADU","1059","80","46","84","5","1274"
201819,"Gedling","LADU","1029","74","49","62","12","1226"
201920,"Gedling","LADU","1046","55","47","86","11","1245"
202021,"Gedling","LADU","1132","33","29","63","10","1267"
201516,"Harborough","LADU","889","75","44","32","1","1041"
201617,"Harborough","LADU","844","57","39","27","2","969"
201718,"Harborough","LADU","647","40","22","20","1","730"
201819,"Harborough","LADU","774","64","42","29","1","910"
201920,"Harborough","LADU","795","62","33","43","3","936"
202021,"Harborough","LADU","893","30","37","34","11","1005"
201516,"High Peak","LADU","855","62","25","48","5","995"
201617,"High Peak","LADU","838","68","30","47","5","988"
201718,"High Peak","LADU","803","55","34","37","2","931"
201819,"High Peak","LADU","711","53","24","42","4","834"
201920,"High Peak","LADU","752","48","23","45","9","877"
202021,"High Peak","LADU","783","26","29","35","5","878"
201516,"Hinckley and Bosworth","LADU","1329","74","47","64","7","1521"
201617,"Hinckley and Bosworth","LADU","1199","82","49","70","7","1407"
201718,"Hinckley and Bosworth","LADU","1147","96","44","59","8","1354"
201819,"Hinckley and Bosworth","LADU","1132","73","34","50","9","1298"
201920,"Hinckley and Bosworth","LADU","1249","84","42","65","5","1445"
202021,"Hinckley and Bosworth","LADU","1405","55","42","61","10","1573"
201516,"Kettering","LADU","944","52","34","64","7","1101"
201617,"Kettering","LADU","910","57","42","76","9","1094"
201718,"Kettering","LADU","905","57","30","47","8","1047"
201819,"Kettering","LADU","943","47","41","66","12","1109"
201920,"Kettering","LADU","977","43","37","40","11","1108"
202021,"Kettering","LADU","1033","33","42","45","12","1165"
201516,"Leicester","LADU","2779","88","83","246","48","3244"
201617,"Leicester","LADU","2867","61","84","243","49","3304"
201718,"Leicester","LADU","2776","60","94","237","50","3217"
201819,"Leicester","LADU","2923","69","125","232","56","3405"
201920,"Leicester","LADU","3001","44","113","257","52","3467"
202021,"Leicester","LADU","3331","34","76","268","73","3782"
201516,"Lincoln","LADU","798","43","28","53","11","933"
201617,"Lincoln","LADU","788","58","26","49","10","931"
201718,"Lincoln","LADU","806","65","24","46","4","945"
201819,"Lincoln","LADU","779","42","24","37","3","885"
201920,"Lincoln","LADU","826","52","26","45","5","954"
202021,"Lincoln","LADU","832","28","22","58","14","954"
201516,"Mansfield","LADU","992","49","41","86","14","1182"
201617,"Mansfield","LADU","993","66","50","61","7","1177"
201718,"Mansfield","LADU","965","56","58","68","9","1156"
201819,"Mansfield","LADU","929","50","49","71","13","1112"
201920,"Mansfield","LADU","905","62","59","64","7","1097"
202021,"Mansfield","LADU","1016","37","45","69","12","1179"
201516,"Melton","LADU","416","30","17","20","4","487"
201617,"Melton","LADU","363","30","22","30","1","446"
201718,"Melton","LADU","366","24","22","19","1","432"
201819,"Melton","LADU","378","23","15","17","2","435"
201920,"Melton","LADU","369","24","9","21","1","424"
202021,"Melton","LADU","405","16","12","23","4","460"
201516,"Newark and Sherwood","LADU","805","69","40","45","6","965"
201617,"Newark and Sherwood","LADU","776","52","33","38","5","904"
201718,"Newark and Sherwood","LADU","709","40","36","40","9","834"
201819,"Newark and Sherwood","LADU","649","37","42","39","5","772"
201920,"Newark and Sherwood","LADU","715","35","28","41","8","827"
202021,"Newark and Sherwood","LADU","745","30","27","41","7","850"
201516,"North East Derbyshire","LADU","654","62","42","32","1","791"
201617,"North East Derbyshire","LADU","612","57","26","30","2","727"
201718,"North East Derbyshire","LADU","604","58","29","32","2","725"
201819,"North East Derbyshire","LADU","597","49","30","39","1","716"
201920,"North East Derbyshire","LADU","643","46","27","41","2","759"
202021,"North East Derbyshire","LADU","633","22","22","38","6","721"
201516,"North Kesteven","LADU","1241","90","30","41","7","1409"
201617,"North Kesteven","LADU","1176","100","33","41","6","1356"
201718,"North Kesteven","LADU","1086","68","34","47","11","1246"
201819,"North Kesteven","LADU","1022","79","40","59","4","1204"
201920,"North Kesteven","LADU","1132","80","32","51","7","1302"
202021,"North Kesteven","LADU","1149","40","31","41","11","1272"
201516,"North West Leicestershire","LADU","745","86","28","50","2","911"
201617,"North West Leicestershire","LADU","745","47","32","54","4","882"
201718,"North West Leicestershire","LADU","690","74","17","44","7","832"
201819,"North West Leicestershire","LADU","703","50","18","37","6","814"
201920,"North West Leicestershire","LADU","828","54","31","56","5","974"
202021,"North West Leicestershire","LADU","859","29","28","44","18","978"
201516,"Northampton","LADU","1659","72","72","130","16","1949"
201617,"Northampton","LADU","1584","75","77","118","20","1874"
201718,"Northampton","LADU","1644","86","89","102","15","1936"
201819,"Northampton","LADU","1581","61","83","106","24","1855"
201920,"Northampton","LADU","1687","65","83","84","21","1940"
202021,"Northampton","LADU","1794","34","50","111","22","2011"
201516,"Nottingham","LADU","1834","101","92","203","31","2261"
201617,"Nottingham","LADU","1699","116","97","230","36","2178"
201718,"Nottingham","LADU","1738","83","84","230","39","2174"
201819,"Nottingham","LADU","1845","78","84","167","49","2223"
201920,"Nottingham","LADU","2009","69","87","219","38","2422"
202021,"Nottingham","LADU","2096","39","90","252","40","2517"
201516,"Oadby and Wigston","LADU","863","56","18","42","6","985"
201617,"Oadby and Wigston","LADU","848","45","18","46","7","964"
201718,"Oadby and Wigston","LADU","817","52","22","46","6","943"
201819,"Oadby and Wigston","LADU","873","52","32","38","8","1003"
201920,"Oadby and Wigston","LADU","856","29","26","54","8","973"
202021,"Oadby and Wigston","LADU","869","36","16","44","14","979"
201516,"Rushcliffe","LADU","1297","56","25","59","8","1445"
201617,"Rushcliffe","LADU","1295","69","30","54","13","1461"
201718,"Rushcliffe","LADU","1269","60","42","56","4","1431"
201819,"Rushcliffe","LADU","1286","60","39","60","7","1452"
201920,"Rushcliffe","LADU","1339","52","40","50","16","1497"
202021,"Rushcliffe","LADU","1482","37","33","58","12","1622"
201516,"Rutland","LADU","435","32","11","19","6","503"
201617,"Rutland","LADU","434","27","11","11","6","489"
201718,"Rutland","LADU","413","22","15","18","5","473"
201819,"Rutland","LADU","399","34","10","12","4","459"
201920,"Rutland","LADU","455","24","8","17","2","506"
202021,"Rutland","LADU","452","14","8","19","4","497"
201516,"South Derbyshire","LADU","703","75","28","30","4","840"
201617,"South Derbyshire","LADU","626","60","30","48","3","767"
201718,"South Derbyshire","LADU","617","58","21","33","2","731"
201819,"South Derbyshire","LADU","620","50","28","21","2","721"
201920,"South Derbyshire","LADU","660","45","14","27","7","753"
202021,"South Derbyshire","LADU","618","26","16","41","4","705"
201516,"South Holland","LADU","914","37","22","36","3","1012"
201617,"South Holland","LADU","821","55","19","38","7","940"
201718,"South Holland","LADU","818","49","25","33","3","928"
201819,"South Holland","LADU","788","47","25","23","5","888"
201920,"South Holland","LADU","780","54","28","20","6","888"
202021,"South Holland","LADU","778","27","29","36","10","880"
201516,"South Kesteven","LADU","1293","61","28","73","4","1459"
201617,"South Kesteven","LADU","1320","69","43","51","8","1491"
201718,"South Kesteven","LADU","1332","65","20","53","10","1480"
201819,"South Kesteven","LADU","1320","61","40","48","10","1479"
201920,"South Kesteven","LADU","1381","54","36","47","10","1528"
202021,"South Kesteven","LADU","1493","39","34","50","15","1631"
201516,"South Northamptonshire","LADU","1181","64","42","38","7","1332"
201617,"South Northamptonshire","LADU","1169","69","53","43","5","1339"
201718,"South Northamptonshire","LADU","1063","68","44","46","9","1230"
201819,"South Northamptonshire","LADU","1095","71","48","43","6","1263"
201920,"South Northamptonshire","LADU","1139","49","51","45","9","1293"
202021,"South Northamptonshire","LADU","1218","29","33","36","5","1321"
201516,"Wellingborough","LADU","694","30","34","55","1","814"
201617,"Wellingborough","LADU","656","53","26","47","5","787"
201718,"Wellingborough","LADU","593","35","33","49","3","713"
201819,"Wellingborough","LADU","608","31","41","34","2","716"
201920,"Wellingborough","LADU","668","30","37","56","6","797"
202021,"Wellingborough","LADU","743","13","24","37","12","829"
201516,"West Lindsey","LADU","953","43","14","39","5","1054"
201617,"West Lindsey","LADU","842","49","18","32","1","942"
201718,"West Lindsey","LADU","812","35","13","27","8","895"
201819,"West Lindsey","LADU","789","32","13","30","10","874"
201920,"West Lindsey","LADU","821","30","15","34","10","910"
202021,"West Lindsey","LADU","810","20","14","27","11","882"
201516,"Birmingham","LADU","10559","311","217","717","159","11963"
201617,"Birmingham","LADU","10327","366","230","630","176","11729"
201718,"Birmingham","LADU","10446","280","215","710","169","11820"
201819,"Birmingham","LADU","10546","245","237","656","184","11868"
201920,"Birmingham","LADU","11365","210","202","718","216","12711"
202021,"Birmingham","LADU","12238","134","184","772","310","13638"
201516,"Bromsgrove","LADU","1095","46","24","32","6","1203"
201617,"Bromsgrove","LADU","1056","52","24","40","7","1179"
201718,"Bromsgrove","LADU","1038","55","34","28","5","1160"
201819,"Bromsgrove","LADU","998","55","31","36","6","1126"
201920,"Bromsgrove","LADU","1054","42","35","37","11","1179"
202021,"Bromsgrove","LADU","1115","20","34","45","10","1224"
201516,"Cannock Chase","LADU","830","64","38","41","2","975"
201617,"Cannock Chase","LADU","798","77","38","41","5","959"
201718,"Cannock Chase","LADU","691","53","36","48","5","833"
201819,"Cannock Chase","LADU","656","72","48","43","3","822"
201920,"Cannock Chase","LADU","661","61","65","46","3","836"
202021,"Cannock Chase","LADU","690","34","46","40","6","816"
201516,"Coventry","LADU","2791","186","99","201","31","3308"
201617,"Coventry","LADU","2841","231","90","165","41","3368"
201718,"Coventry","LADU","2805","138","116","189","36","3284"
201819,"Coventry","LADU","2757","154","98","232","61","3302"
201920,"Coventry","LADU","2885","142","119","207","65","3418"
202021,"Coventry","LADU","3228","81","68","240","66","3683"
201516,"Dudley","LADU","3087","178","96","174","25","3560"
201617,"Dudley","LADU","2998","218","98","193","20","3527"
201718,"Dudley","LADU","2900","171","102","200","27","3400"
201819,"Dudley","LADU","2777","155","81","180","25","3218"
201920,"Dudley","LADU","2781","144","103","171","26","3225"
202021,"Dudley","LADU","2827","103","100","179","27","3236"
201516,"East Staffordshire","LADU","1220","118","37","42","7","1424"
201617,"East Staffordshire","LADU","1226","115","44","58","3","1446"
201718,"East Staffordshire","LADU","1281","102","46","57","8","1494"
201819,"East Staffordshire","LADU","1308","99","47","34","7","1495"
201920,"East Staffordshire","LADU","1272","88","51","61","12","1484"
202021,"East Staffordshire","LADU","1492","53","43","45","18","1651"
201516,"Herefordshire, County of","LADU","1585","96","65","76","10","1832"
201617,"Herefordshire, County of","LADU","1470","91","63","70","10","1704"
201718,"Herefordshire, County of","LADU","1483","73","55","74","11","1696"
201819,"Herefordshire, County of","LADU","1394","90","53","67","9","1613"
201920,"Herefordshire, County of","LADU","1413","78","65","96","14","1666"
202021,"Herefordshire, County of","LADU","1541","55","54","82","17","1749"
201516,"Lichfield","LADU","965","47","28","28","1","1069"
201617,"Lichfield","LADU","918","66","26","32","4","1046"
201718,"Lichfield","LADU","886","81","20","39","8","1034"
201819,"Lichfield","LADU","872","71","27","28","11","1009"
201920,"Lichfield","LADU","929","60","35","35","5","1064"
202021,"Lichfield","LADU","994","38","41","27","9","1109"
201516,"Malvern Hills","LADU","652","38","26","26","1","743"
201617,"Malvern Hills","LADU","631","46","23","26","3","729"
201718,"Malvern Hills","LADU","577","34","29","23","6","669"
201819,"Malvern Hills","LADU","607","29","19","23","3","681"
201920,"Malvern Hills","LADU","585","28","30","31","4","678"
202021,"Malvern Hills","LADU","630","15","24","36","4","709"
201516,"Newcastle-under-Lyme","LADU","1001","78","44","43","3","1169"
201617,"Newcastle-under-Lyme","LADU","1029","87","58","56","5","1235"
201718,"Newcastle-under-Lyme","LADU","914","78","38","46","2","1078"
201819,"Newcastle-under-Lyme","LADU","887","55","49","49","6","1046"
201920,"Newcastle-under-Lyme","LADU","949","67","51","55","5","1127"
202021,"Newcastle-under-Lyme","LADU","1011","44","32","70","6","1163"
201516,"North Warwickshire","LADU","647","43","33","37","3","763"
201617,"North Warwickshire","LADU","589","50","44","45","8","736"
201718,"North Warwickshire","LADU","622","47","41","43","4","757"
201819,"North Warwickshire","LADU","662","48","35","38","6","789"
201920,"North Warwickshire","LADU","699","36","45","55","7","842"
202021,"North Warwickshire","LADU","772","35","40","43","8","898"
201516,"Nuneaton and Bedworth","LADU","1041","100","45","71","11","1268"
201617,"Nuneaton and Bedworth","LADU","974","78","45","64","10","1171"
201718,"Nuneaton and Bedworth","LADU","1000","58","56","49","8","1171"
201819,"Nuneaton and Bedworth","LADU","893","61","52","62","8","1076"
201920,"Nuneaton and Bedworth","LADU","962","35","49","48","9","1103"
202021,"Nuneaton and Bedworth","LADU","985","36","38","81","16","1156"
201516,"Redditch","LADU","650","45","35","42","5","777"
201617,"Redditch","LADU","657","44","44","40","4","789"
201718,"Redditch","LADU","632","32","44","36","3","747"
201819,"Redditch","LADU","599","32","28","32","5","696"
201920,"Redditch","LADU","601","26","30","38","5","700"
202021,"Redditch","LADU","720","27","24","41","5","817"
201516,"Rugby","LADU","921","46","29","61","3","1060"
201617,"Rugby","LADU","886","54","31","34","1","1006"
201718,"Rugby","LADU","907","40","20","38","4","1009"
201819,"Rugby","LADU","864","34","24","32","13","967"
201920,"Rugby","LADU","917","29","25","49","8","1028"
202021,"Rugby","LADU","961","17","18","33","10","1039"
201516,"Sandwell","LADU","2947","158","94","212","28","3439"
201617,"Sandwell","LADU","2973","157","101","190","31","3452"
201718,"Sandwell","LADU","3051","127","103","187","43","3511"
201819,"Sandwell","LADU","3058","134","109","236","43","3580"
201920,"Sandwell","LADU","3133","127","109","207","31","3607"
202021,"Sandwell","LADU","3342","66","77","181","50","3716"
201516,"Shropshire","LADU","2559","179","125","127","32","3022"
201617,"Shropshire","LADU","2503","162","133","119","34","2951"
201718,"Shropshire","LADU","2343","149","108","131","24","2755"
201819,"Shropshire","LADU","2357","140","141","114","47","2799"
201920,"Shropshire","LADU","2399","136","148","141","75","2899"
202021,"Shropshire","LADU","2470","81","104","147","68","2870"
201516,"Solihull","LADU","2614","180","76","120","18","3008"
201617,"Solihull","LADU","2530","154","91","132","32","2939"
201718,"Solihull","LADU","2460","140","108","142","23","2873"
201819,"Solihull","LADU","2501","119","67","154","30","2871"
201920,"Solihull","LADU","2545","99","91","127","28","2890"
202021,"Solihull","LADU","2665","70","63","156","28","2982"
201516,"South Staffordshire","LADU","994","82","40","48","4","1168"
201617,"South Staffordshire","LADU","925","90","24","38","2","1079"
201718,"South Staffordshire","LADU","829","82","23","35","8","977"
201819,"South Staffordshire","LADU","880","79","37","43","11","1050"
201920,"South Staffordshire","LADU","843","82","38","40","8","1011"
202021,"South Staffordshire","LADU","871","49","36","56","5","1017"
201516,"Stafford","LADU","935","57","33","43","1","1069"
201617,"Stafford","LADU","865","51","36","23","6","981"
201718,"Stafford","LADU","857","55","17","36","7","972"
201819,"Stafford","LADU","819","50","30","36","4","939"
201920,"Stafford","LADU","894","31","36","44","2","1007"
202021,"Stafford","LADU","927","32","29","47","7","1042"
201516,"Staffordshire Moorlands","LADU","1090","83","31","52","4","1260"
201617,"Staffordshire Moorlands","LADU","995","94","29","54","7","1179"
201718,"Staffordshire Moorlands","LADU","1026","91","30","45","4","1196"
201819,"Staffordshire Moorlands","LADU","950","89","55","35","11","1140"
201920,"Staffordshire Moorlands","LADU","1034","63","42","39","9","1187"
202021,"Staffordshire Moorlands","LADU","1114","51","38","35","13","1251"
201516,"Stoke-on-Trent","LADU","1950","130","106","142","2","2330"
201617,"Stoke-on-Trent","LADU","1839","116","112","136","10","2213"
201718,"Stoke-on-Trent","LADU","1771","106","123","125","20","2145"
201819,"Stoke-on-Trent","LADU","1715","96","142","141","15","2109"
201920,"Stoke-on-Trent","LADU","1842","96","147","222","19","2326"
202021,"Stoke-on-Trent","LADU","2079","66","115","231","18","2509"
201516,"Stratford-on-Avon","LADU","1370","57","30","25","3","1485"
201617,"Stratford-on-Avon","LADU","1329","60","27","48","8","1472"
201718,"Stratford-on-Avon","LADU","1292","59","40","34","5","1430"
201819,"Stratford-on-Avon","LADU","1302","66","30","41","3","1442"
201920,"Stratford-on-Avon","LADU","1299","77","28","43","10","1457"
202021,"Stratford-on-Avon","LADU","1480","43","36","57","13","1629"
201516,"Tamworth","LADU","535","25","37","40","0","637"
201617,"Tamworth","LADU","528","43","29","29","5","634"
201718,"Tamworth","LADU","540","27","13","32","12","624"
201819,"Tamworth","LADU","468","30","21","30","7","556"
201920,"Tamworth","LADU","456","22","17","33","3","531"
202021,"Tamworth","LADU","510","12","21","48","9","600"
201516,"Telford and Wrekin","LADU","1647","87","76","128","13","1951"
201617,"Telford and Wrekin","LADU","1680","88","59","124","8","1959"
201718,"Telford and Wrekin","LADU","1539","75","48","113","10","1785"
201819,"Telford and Wrekin","LADU","1607","77","61","113","9","1867"
201920,"Telford and Wrekin","LADU","1639","87","50","101","9","1886"
202021,"Telford and Wrekin","LADU","1781","68","32","101","8","1990"
201516,"Walsall","LADU","2543","136","96","187","24","2986"
201617,"Walsall","LADU","2544","148","89","176","23","2980"
201718,"Walsall","LADU","2468","125","84","137","44","2858"
201819,"Walsall","LADU","2577","125","78","123","31","2934"
201920,"Walsall","LADU","2642","103","83","148","34","3010"
202021,"Walsall","LADU","2742","55","92","149","47","3085"
201516,"Warwick","LADU","1008","44","18","35","3","1108"
201617,"Warwick","LADU","964","31","29","54","8","1086"
201718,"Warwick","LADU","904","36","21","43","6","1010"
201819,"Warwick","LADU","957","41","36","36","9","1079"
201920,"Warwick","LADU","966","39","31","35","12","1083"
202021,"Warwick","LADU","1042","18","17","49","13","1139"
201516,"Wolverhampton","LADU","2349","93","66","174","21","2703"
201617,"Wolverhampton","LADU","2255","117","65","166","24","2627"
201718,"Wolverhampton","LADU","2319","90","68","155","42","2674"
201819,"Wolverhampton","LADU","2458","104","53","140","32","2787"
201920,"Wolverhampton","LADU","2578","82","58","181","35","2934"
202021,"Wolverhampton","LADU","2872","51","58","153","50","3184"
201516,"Worcester","LADU","840","58","43","37","6","984"
201617,"Worcester","LADU","850","55","32","48","7","992"
201718,"Worcester","LADU","831","53","35","49","4","972"
201819,"Worcester","LADU","838","49","37","44","7","975"
201920,"Worcester","LADU","833","56","35","51","11","986"
202021,"Worcester","LADU","879","32","38","44","6","999"
201516,"Wychavon","LADU","829","45","33","44","10","961"
201617,"Wychavon","LADU","770","51","36","44","6","907"
201718,"Wychavon","LADU","777","53","35","39","7","911"
201819,"Wychavon","LADU","732","53","43","31","2","861"
201920,"Wychavon","LADU","806","39","41","45","14","945"
202021,"Wychavon","LADU","827","33","35","47","3","945"
201516,"Wyre Forest","LADU","776","59","47","31","2","915"
201617,"Wyre Forest","LADU","770","51","18","28","4","871"
201718,"Wyre Forest","LADU","686","45","20","29","7","787"
201819,"Wyre Forest","LADU","691","51","31","27","4","804"
201920,"Wyre Forest","LADU","737","38","27","41","5","848"
202021,"Wyre Forest","LADU","744","25","28","34","2","833"
201516,"Babergh","LADU","696","56","22","29","2","805"
201617,"Babergh","LADU","685","37","27","29","2","780"
201718,"Babergh","LADU","639","39","19","27","7","731"
201819,"Babergh","LADU","603","36","31","38","3","711"
201920,"Babergh","LADU","638","30","37","30","4","739"
202021,"Babergh","LADU","753","31","25","38","2","849"
201516,"Basildon","LADU","1574","113","87","106","16","1896"
201617,"Basildon","LADU","1436","97","89","118","6","1746"
201718,"Basildon","LADU","1369","81","60","88","6","1604"
201819,"Basildon","LADU","1350","81","74","94","10","1609"
201920,"Basildon","LADU","1402","56","71","80","12","1621"
202021,"Basildon","LADU","1515","32","59","84","14","1704"
201516,"Bedford","LADU","1646","71","48","89","7","1861"
201617,"Bedford","LADU","1614","68","42","94","15","1833"
201718,"Bedford","LADU","1547","76","61","98","15","1797"
201819,"Bedford","LADU","1570","63","64","96","10","1803"
201920,"Bedford","LADU","1624","43","55","74","18","1814"
202021,"Bedford","LADU","1760","26","31","79","24","1920"
201516,"Braintree","LADU","1202","79","45","61","9","1396"
201617,"Braintree","LADU","1171","65","65","67","8","1376"
201718,"Braintree","LADU","1178","61","54","70","9","1372"
201819,"Braintree","LADU","1104","60","48","63","8","1283"
201920,"Braintree","LADU","1180","45","49","69","6","1349"
202021,"Braintree","LADU","1162","39","36","77","11","1325"
201516,"Breckland","LADU","1040","61","41","67","10","1219"
201617,"Breckland","LADU","998","56","44","66","4","1168"
201718,"Breckland","LADU","957","59","40","53","5","1114"
201819,"Breckland","LADU","942","58","33","64","6","1103"
201920,"Breckland","LADU","921","44","37","56","7","1065"
202021,"Breckland","LADU","987","35","31","60","8","1121"
201516,"Brentwood","LADU","1013","45","18","41","8","1125"
201617,"Brentwood","LADU","984","37","26","33","4","1084"
201718,"Brentwood","LADU","1027","34","29","24","6","1120"
201819,"Brentwood","LADU","997","36","17","32","5","1087"
201920,"Brentwood","LADU","1031","45","21","46","11","1154"
202021,"Brentwood","LADU","1061","26","18","35","9","1149"
201516,"Broadland","LADU","1285","96","48","75","5","1509"
201617,"Broadland","LADU","1221","71","39","57","4","1392"
201718,"Broadland","LADU","1237","78","44","62","7","1428"
201819,"Broadland","LADU","1206","70","36","46","8","1366"
201920,"Broadland","LADU","1189","63","44","53","9","1358"
202021,"Broadland","LADU","1258","52","25","68","3","1406"
201516,"Broxbourne","LADU","967","38","24","47","5","1081"
201617,"Broxbourne","LADU","968","40","23","43","10","1084"
201718,"Broxbourne","LADU","962","41","18","41","3","1065"
201819,"Broxbourne","LADU","979","36","21","33","4","1073"
201920,"Broxbourne","LADU","979","33","33","44","4","1093"
202021,"Broxbourne","LADU","1021","27","14","38","5","1105"
201516,"Cambridge","LADU","701","15","18","41","7","782"
201617,"Cambridge","LADU","791","22","27","37","12","889"
201718,"Cambridge","LADU","780","20","21","38","11","870"
201819,"Cambridge","LADU","695","15","24","31","11","776"
201920,"Cambridge","LADU","752","19","15","41","14","841"
202021,"Cambridge","LADU","828","8","10","47","12","905"
201516,"Castle Point","LADU","958","55","60","56","6","1135"
201617,"Castle Point","LADU","835","86","35","53","7","1016"
201718,"Castle Point","LADU","869","47","43","57","5","1021"
201819,"Castle Point","LADU","794","61","27","54","4","940"
201920,"Castle Point","LADU","839","50","34","52","7","982"
202021,"Castle Point","LADU","947","22","31","56","8","1064"
201516,"Central Bedfordshire","LADU","2283","147","83","117","25","2655"
201617,"Central Bedfordshire","LADU","2235","132","62","97","17","2543"
201718,"Central Bedfordshire","LADU","2196","134","94","94","18","2536"
201819,"Central Bedfordshire","LADU","2144","127","105","100","31","2507"
201920,"Central Bedfordshire","LADU","2323","108","99","104","29","2663"
202021,"Central Bedfordshire","LADU","2398","51","66","139","16","2670"
201516,"Chelmsford","LADU","1772","88","56","83","11","2010"
201617,"Chelmsford","LADU","1710","81","62","66","4","1923"
201718,"Chelmsford","LADU","1709","87","62","69","7","1934"
201819,"Chelmsford","LADU","1678","73","59","80","13","1903"
201920,"Chelmsford","LADU","1755","68","50","61","9","1943"
202021,"Chelmsford","LADU","1820","33","41","71","17","1982"
201516,"Colchester","LADU","1589","76","49","75","5","1794"
201617,"Colchester","LADU","1544","69","63","72","9","1757"
201718,"Colchester","LADU","1532","60","47","74","8","1721"
201819,"Colchester","LADU","1510","60","38","71","11","1690"
201920,"Colchester","LADU","1586","56","65","90","9","1806"
202021,"Colchester","LADU","1817","33","46","82","3","1981"
201516,"Dacorum","LADU","1391","62","41","55","4","1553"
201617,"Dacorum","LADU","1278","46","58","63","7","1452"
201718,"Dacorum","LADU","1346","61","50","62","9","1528"
201819,"Dacorum","LADU","1292","43","54","60","11","1460"
201920,"Dacorum","LADU","1289","33","46","47","13","1428"
202021,"Dacorum","LADU","1361","20","32","58","9","1480"
201516,"East Cambridgeshire","LADU","745","44","28","40","5","862"
201617,"East Cambridgeshire","LADU","693","51","20","37","3","804"
201718,"East Cambridgeshire","LADU","669","44","21","31","2","767"
201819,"East Cambridgeshire","LADU","679","56","35","43","3","816"
201920,"East Cambridgeshire","LADU","772","35","32","31","2","872"
202021,"East Cambridgeshire","LADU","799","33","21","24","6","883"
201516,"East Hertfordshire","LADU","1767","42","38","51","13","1911"
201617,"East Hertfordshire","LADU","1758","55","42","42","13","1910"
201718,"East Hertfordshire","LADU","1766","58","43","25","5","1897"
201819,"East Hertfordshire","LADU","1770","49","38","39","10","1906"
201920,"East Hertfordshire","LADU","1832","50","36","49","12","1979"
202021,"East Hertfordshire","LADU","1816","28","32","53","15","1944"
201920,"East Suffolk","LADU","1936","106","54","66","5","2167"
202021,"East Suffolk","LADU","1997","69","61","96","19","2242"
201516,"Epping Forest","LADU","869","48","31","59","5","1012"
201617,"Epping Forest","LADU","886","49","23","40","8","1006"
201718,"Epping Forest","LADU","855","24","30","42","7","958"
201819,"Epping Forest","LADU","852","44","27","38","6","967"
201920,"Epping Forest","LADU","925","33","19","41","8","1026"
202021,"Epping Forest","LADU","1007","17","23","47","13","1107"
201516,"Fenland","LADU","723","49","38","70","3","883"
201617,"Fenland","LADU","741","47","44","48","10","890"
201718,"Fenland","LADU","684","33","37","49","5","808"
201819,"Fenland","LADU","648","42","26","45","8","769"
201920,"Fenland","LADU","680","25","25","61","5","796"
202021,"Fenland","LADU","719","22","24","50","11","826"
201516,"Forest Heath","LADU","314","16","17","15","2","364"
201617,"Forest Heath","LADU","251","29","29","17","0","326"
201718,"Forest Heath","LADU","295","26","25","11","2","359"
201819,"Forest Heath","LADU","288","16","21","14","1","340"
201516,"Great Yarmouth","LADU","878","34","24","69","6","1011"
201617,"Great Yarmouth","LADU","858","28","22","64","2","974"
201718,"Great Yarmouth","LADU","835","34","16","43","7","935"
201819,"Great Yarmouth","LADU","788","32","19","52","3","894"
201920,"Great Yarmouth","LADU","835","25","25","33","6","924"
202021,"Great Yarmouth","LADU","893","14","12","42","5","966"
201516,"Harlow","LADU","781","48","21","35","4","889"
201617,"Harlow","LADU","801","40","30","32","8","911"
201718,"Harlow","LADU","795","33","23","43","11","905"
201819,"Harlow","LADU","765","34","27","53","7","886"
201920,"Harlow","LADU","779","25","22","37","7","870"
202021,"Harlow","LADU","848","19","23","71","15","976"
201516,"Hertsmere","LADU","1184","40","40","55","11","1330"
201617,"Hertsmere","LADU","1198","33","36","36","6","1309"
201718,"Hertsmere","LADU","1261","30","30","48","9","1378"
201819,"Hertsmere","LADU","1149","24","33","42","8","1256"
201920,"Hertsmere","LADU","1232","27","40","54","10","1363"
202021,"Hertsmere","LADU","1290","13","24","46","14","1387"
201516,"Huntingdonshire","LADU","1442","67","59","49","9","1626"
201617,"Huntingdonshire","LADU","1387","66","56","64","9","1582"
201718,"Huntingdonshire","LADU","1361","58","61","56","12","1548"
201819,"Huntingdonshire","LADU","1210","52","65","75","16","1418"
201920,"Huntingdonshire","LADU","1257","54","61","61","7","1440"
202021,"Huntingdonshire","LADU","1260","32","47","75","8","1422"
201516,"Ipswich","LADU","1181","106","52","99","7","1445"
201617,"Ipswich","LADU","1154","93","46","76","5","1374"
201718,"Ipswich","LADU","1074","73","47","52","6","1252"
201819,"Ipswich","LADU","1128","53","32","60","16","1289"
201920,"Ipswich","LADU","1179","51","48","64","11","1353"
202021,"Ipswich","LADU","1293","32","37","77","18","1457"
201516,"King's Lynn and West Norfolk","LADU","1118","78","56","61","10","1323"
201617,"King's Lynn and West Norfolk","LADU","1094","87","60","68","6","1315"
201718,"King's Lynn and West Norfolk","LADU","1058","77","70","88","10","1303"
201819,"King's Lynn and West Norfolk","LADU","1025","74","50","66","4","1219"
201920,"King's Lynn and West Norfolk","LADU","1042","66","47","54","15","1224"
202021,"King's Lynn and West Norfolk","LADU","1064","50","49","81","6","1250"
201516,"Luton","LADU","2164","71","42","135","32","2444"
201617,"Luton","LADU","2123","66","54","134","40","2417"
201718,"Luton","LADU","2150","57","51","114","38","2410"
201819,"Luton","LADU","2294","42","47","122","41","2546"
201920,"Luton","LADU","2354","42","44","92","42","2574"
202021,"Luton","LADU","2507","32","26","122","30","2717"
201516,"Maldon","LADU","347","37","21","20","2","427"
201617,"Maldon","LADU","336","25","19","13","2","395"
201718,"Maldon","LADU","336","14","19","35","2","406"
201819,"Maldon","LADU","345","13","16","23","0","397"
201920,"Maldon","LADU","398","13","21","22","3","457"
202021,"Maldon","LADU","373","9","19","28","4","433"
201516,"Mid Suffolk","LADU","1068","75","37","35","4","1219"
201617,"Mid Suffolk","LADU","981","89","37","43","5","1155"
201718,"Mid Suffolk","LADU","900","64","30","31","5","1030"
201819,"Mid Suffolk","LADU","965","64","29","38","3","1099"
201920,"Mid Suffolk","LADU","916","59","51","36","5","1067"
202021,"Mid Suffolk","LADU","1017","33","35","41","6","1132"
201516,"North Hertfordshire","LADU","1007","33","44","63","6","1153"
201617,"North Hertfordshire","LADU","947","44","40","43","2","1076"
201718,"North Hertfordshire","LADU","1018","30","33","39","3","1123"
201819,"North Hertfordshire","LADU","927","21","44","38","6","1036"
201920,"North Hertfordshire","LADU","937","25","28","32","7","1029"
202021,"North Hertfordshire","LADU","1000","17","29","42","3","1091"
201516,"North Norfolk","LADU","656","37","38","52","3","786"
201617,"North Norfolk","LADU","610","43","32","34","3","722"
201718,"North Norfolk","LADU","649","49","24","25","0","747"
201819,"North Norfolk","LADU","622","52","37","36","0","747"
201920,"North Norfolk","LADU","628","37","42","26","2","735"
202021,"North Norfolk","LADU","653","30","29","42","6","760"
201516,"Norwich","LADU","810","33","27","68","4","942"
201617,"Norwich","LADU","871","35","34","64","4","1008"
201718,"Norwich","LADU","813","19","33","64","4","933"
201819,"Norwich","LADU","749","32","18","48","8","855"
201920,"Norwich","LADU","835","42","22","56","4","959"
202021,"Norwich","LADU","929","9","24","55","10","1027"
201516,"Peterborough","LADU","1890","78","63","134","22","2187"
201617,"Peterborough","LADU","1947","71","68","124","27","2237"
201718,"Peterborough","LADU","1930","54","50","120","19","2173"
201819,"Peterborough","LADU","1945","67","68","127","23","2230"
201920,"Peterborough","LADU","2011","61","50","112","24","2258"
202021,"Peterborough","LADU","2209","33","63","124","45","2474"
201516,"Rochford","LADU","909","54","37","47","5","1052"
201617,"Rochford","LADU","894","70","29","41","7","1041"
201718,"Rochford","LADU","910","60","28","37","5","1040"
201819,"Rochford","LADU","797","55","54","59","3","968"
201920,"Rochford","LADU","862","45","38","50","4","999"
202021,"Rochford","LADU","915","20","31","35","3","1004"
201516,"South Cambridgeshire","LADU","1382","65","51","36","9","1543"
201617,"South Cambridgeshire","LADU","1269","62","51","40","5","1427"
201718,"South Cambridgeshire","LADU","1343","64","58","58","4","1527"
201819,"South Cambridgeshire","LADU","1414","61","58","65","12","1610"
201920,"South Cambridgeshire","LADU","1491","57","61","50","8","1667"
202021,"South Cambridgeshire","LADU","1543","29","35","40","13","1660"
201516,"South Norfolk","LADU","1228","70","26","41","4","1369"
201617,"South Norfolk","LADU","1159","66","31","60","2","1318"
201718,"South Norfolk","LADU","1148","50","34","32","10","1274"
201819,"South Norfolk","LADU","1069","44","31","30","4","1178"
201920,"South Norfolk","LADU","1131","38","28","45","9","1251"
202021,"South Norfolk","LADU","1188","32","31","49","8","1308"
201516,"Southend-on-Sea","LADU","1866","47","45","87","12","2057"
201617,"Southend-on-Sea","LADU","1797","49","48","93","12","1999"
201718,"Southend-on-Sea","LADU","1841","55","54","75","30","2055"
201819,"Southend-on-Sea","LADU","1783","40","43","84","8","1958"
201920,"Southend-on-Sea","LADU","1859","41","45","82","22","2049"
202021,"Southend-on-Sea","LADU","1984","16","37","96","34","2167"
201516,"St Albans","LADU","1762","53","27","46","5","1893"
201617,"St Albans","LADU","1753","48","25","32","8","1866"
201718,"St Albans","LADU","1721","39","37","27","17","1841"
201819,"St Albans","LADU","1712","19","25","38","13","1807"
201920,"St Albans","LADU","1834","22","25","36","15","1932"
202021,"St Albans","LADU","1937","14","12","32","14","2009"
201516,"St Edmundsbury","LADU","1036","37","31","45","5","1154"
201617,"St Edmundsbury","LADU","1007","51","37","53","4","1152"
201718,"St Edmundsbury","LADU","1026","50","42","34","4","1156"
201819,"St Edmundsbury","LADU","985","58","29","55","10","1137"
201516,"Stevenage","LADU","942","35","34","47","6","1064"
201617,"Stevenage","LADU","962","61","47","56","4","1130"
201718,"Stevenage","LADU","903","42","46","51","6","1048"
201819,"Stevenage","LADU","901","29","38","40","7","1015"
201920,"Stevenage","LADU","987","29","41","42","6","1105"
202021,"Stevenage","LADU","1049","16","16","54","7","1142"
201516,"Suffolk Coastal","LADU","1022","73","34","61","5","1195"
201617,"Suffolk Coastal","LADU","984","78","23","46","2","1133"
201718,"Suffolk Coastal","LADU","926","56","32","44","5","1063"
201819,"Suffolk Coastal","LADU","915","57","35","30","3","1040"
201516,"Tendring","LADU","1284","89","37","80","4","1494"
201617,"Tendring","LADU","1175","69","81","99","9","1433"
201718,"Tendring","LADU","1145","75","50","74","5","1349"
201819,"Tendring","LADU","1137","53","57","68","12","1327"
201920,"Tendring","LADU","1116","52","50","102","9","1329"
202021,"Tendring","LADU","1246","39","46","117","15","1463"
201516,"Three Rivers","LADU","916","20","8","17","7","968"
201617,"Three Rivers","LADU","908","16","13","17","6","960"
201718,"Three Rivers","LADU","920","35","7","15","2","979"
201819,"Three Rivers","LADU","976","13","13","25","9","1036"
201920,"Three Rivers","LADU","1026","17","14","16","4","1077"
202021,"Three Rivers","LADU","1067","6","19","17","10","1119"
201516,"Thurrock","LADU","1485","74","74","82","10","1725"
201617,"Thurrock","LADU","1452","60","69","87","15","1683"
201718,"Thurrock","LADU","1338","67","85","99","12","1601"
201819,"Thurrock","LADU","1345","71","70","101","10","1597"
201920,"Thurrock","LADU","1439","89","80","92","16","1716"
202021,"Thurrock","LADU","1617","41","50","109","15","1832"
201516,"Uttlesford","LADU","708","25","16","28","7","784"
201617,"Uttlesford","LADU","600","33","18","33","2","686"
201718,"Uttlesford","LADU","648","27","24","23","6","728"
201819,"Uttlesford","LADU","642","35","23","18","5","723"
201920,"Uttlesford","LADU","627","18","24","20","5","694"
202021,"Uttlesford","LADU","709","12","14","17","5","757"
201516,"Watford","LADU","676","12","10","24","4","726"
201617,"Watford","LADU","676","13","13","35","4","741"
201718,"Watford","LADU","688","16","14","32","1","751"
201819,"Watford","LADU","674","3","15","18","6","716"
201920,"Watford","LADU","707","6","15","26","13","767"
202021,"Watford","LADU","713","10","6","16","4","749"
201516,"Waveney","LADU","976","43","27","68","3","1117"
201617,"Waveney","LADU","982","58","32","52","1","1125"
201718,"Waveney","LADU","916","41","30","42","5","1034"
201819,"Waveney","LADU","920","41","24","52","5","1042"
201516,"Welwyn Hatfield","LADU","788","44","16","35","7","890"
201617,"Welwyn Hatfield","LADU","762","34","23","35","3","857"
201718,"Welwyn Hatfield","LADU","770","29","27","44","2","872"
201819,"Welwyn Hatfield","LADU","776","28","25","35","4","868"
201920,"Welwyn Hatfield","LADU","798","32","25","30","7","892"
202021,"Welwyn Hatfield","LADU","876","10","12","35","7","940"
201920,"West Suffolk","LADU","1329","71","68","59","10","1537"
202021,"West Suffolk","LADU","1483","41","29","56","7","1616"
201516,"Barking and Dagenham","LADU","1862","67","40","116","14","2099"
201617,"Barking and Dagenham","LADU","1942","45","42","126","28","2183"
201718,"Barking and Dagenham","LADU","1957","46","32","104","29","2168"
201819,"Barking and Dagenham","LADU","2003","31","36","89","22","2181"
201920,"Barking and Dagenham","LADU","2101","36","41","118","30","2326"
202021,"Barking and Dagenham","LADU","2306","15","16","110","44","2491"
201516,"Barnet","LADU","3302","58","18","123","43","3544"
201617,"Barnet","LADU","3353","61","27","130","46","3617"
201718,"Barnet","LADU","3213","47","37","111","50","3458"
201819,"Barnet","LADU","3513","42","24","97","58","3734"
201920,"Barnet","LADU","3517","32","23","96","58","3726"
202021,"Barnet","LADU","3740","11","18","79","66","3914"
201516,"Bexley","LADU","2893","146","80","110","19","3248"
201617,"Bexley","LADU","2773","142","97","114","15","3141"
201718,"Bexley","LADU","2712","139","104","119","21","3095"
201819,"Bexley","LADU","2645","118","83","105","38","2989"
201920,"Bexley","LADU","2744","110","82","91","31","3058"
202021,"Bexley","LADU","2857","60","59","99","38","3113"
201516,"Brent","LADU","2748","24","23","138","35","2968"
201617,"Brent","LADU","2772","23","23","116","67","3001"
201718,"Brent","LADU","2713","12","18","126","37","2906"
201819,"Brent","LADU","2669","13","30","106","44","2862"
201920,"Brent","LADU","2820","12","40","125","46","3043"
202021,"Brent","LADU","2925","7","15","89","46","3082"
201516,"Bromley","LADU","2926","108","72","104","27","3237"
201617,"Bromley","LADU","2928","112","81","114","16","3251"
201718,"Bromley","LADU","2837","106","92","138","27","3200"
201819,"Bromley","LADU","2813","92","95","129","23","3152"
201920,"Bromley","LADU","2921","99","69","101","38","3228"
202021,"Bromley","LADU","3119","35","51","87","42","3334"
201516,"Camden","LADU","1243","20","16","82","15","1376"
201617,"Camden","LADU","1238","18","24","91","23","1394"
201718,"Camden","LADU","1354","10","18","82","21","1485"
201819,"Camden","LADU","1373","14","15","80","20","1502"
201920,"Camden","LADU","1423","8","18","82","11","1542"
202021,"Camden","LADU","1468","8","9","42","21","1548"
201516,"Croydon","LADU","3227","89","64","146","47","3573"
201617,"Croydon","LADU","3370","78","86","181","51","3766"
201718,"Croydon","LADU","3195","42","58","179","36","3510"
201819,"Croydon","LADU","3069","50","61","165","31","3376"
201920,"Croydon","LADU","3249","48","58","159","23","3537"
202021,"Croydon","LADU","3407","29","28","139","47","3650"
201516,"Ealing","LADU","2545","31","42","105","37","2760"
201617,"Ealing","LADU","2490","34","39","118","44","2725"
201718,"Ealing","LADU","2496","25","31","97","30","2679"
201819,"Ealing","LADU","2600","20","34","109","39","2802"
201920,"Ealing","LADU","2716","22","26","93","38","2895"
202021,"Ealing","LADU","2830","15","15","84","47","2991"
201516,"Enfield","LADU","3241","88","55","160","48","3592"
201617,"Enfield","LADU","3201","67","56","145","47","3516"
201718,"Enfield","LADU","3186","44","43","127","36","3436"
201819,"Enfield","LADU","3080","32","41","136","60","3349"
201920,"Enfield","LADU","3000","24","53","161","67","3305"
202021,"Enfield","LADU","3408","18","35","148","85","3694"
201516,"Greenwich","LADU","1831","62","47","161","25","2126"
201617,"Greenwich","LADU","1906","64","52","115","24","2161"
201718,"Greenwich","LADU","1899","43","53","113","22","2130"
201819,"Greenwich","LADU","1957","46","53","121","48","2225"
201920,"Greenwich","LADU","2285","40","64","135","39","2563"
202021,"Greenwich","LADU","2212","29","37","95","50","2423"
201516,"Hackney","LADU","1749","21","21","105","43","1939"
201617,"Hackney","LADU","1847","23","16","84","33","2003"
201718,"Hackney","LADU","1830","14","24","73","26","1967"
201819,"Hackney","LADU","1870","16","22","84","32","2024"
201920,"Hackney","LADU","2027","16","29","85","31","2188"
202021,"Hackney","LADU","2085","13","19","95","32","2244"
201516,"Hammersmith and Fulham","LADU","955","9","12","49","26","1051"
201617,"Hammersmith and Fulham","LADU","1169","12","16","67","36","1300"
201718,"Hammersmith and Fulham","LADU","1145","7","20","62","23","1257"
201819,"Hammersmith and Fulham","LADU","1145","9","19","40","32","1245"
201920,"Hammersmith and Fulham","LADU","1179","10","14","47","29","1279"
202021,"Hammersmith and Fulham","LADU","1308","11","7","35","35","1396"
201516,"Haringey","LADU","1875","30","19","112","34","2070"
201617,"Haringey","LADU","1971","22","19","134","43","2189"
201718,"Haringey","LADU","1890","13","29","117","35","2084"
201819,"Haringey","LADU","1958","13","19","116","38","2144"
201920,"Haringey","LADU","2090","18","18","106","63","2295"
202021,"Haringey","LADU","2250","7","13","79","87","2436"
201516,"Harrow","LADU","1967","22","12","59","16","2076"
201617,"Harrow","LADU","1978","24","10","60","22","2094"
201718,"Harrow","LADU","1926","8","21","48","18","2021"
201819,"Harrow","LADU","1906","12","15","50","19","2002"
201920,"Harrow","LADU","2074","12","9","59","15","2169"
202021,"Harrow","LADU","2168","7","11","71","43","2300"
201516,"Havering","LADU","2635","175","94","135","13","3052"
201617,"Havering","LADU","2522","153","84","120","10","2889"
201718,"Havering","LADU","2433","123","72","122","17","2767"
201819,"Havering","LADU","2425","95","89","122","17","2748"
201920,"Havering","LADU","2523","100","67","103","14","2807"
202021,"Havering","LADU","2558","48","55","125","25","2811"
201516,"Hillingdon","LADU","2625","116","64","120","53","2978"
201617,"Hillingdon","LADU","2759","97","58","127","52","3093"
201718,"Hillingdon","LADU","2689","94","55","141","42","3021"
201819,"Hillingdon","LADU","2693","84","53","129","45","3004"
201920,"Hillingdon","LADU","2835","86","64","109","44","3138"
202021,"Hillingdon","LADU","2972","39","59","108","59","3237"
201516,"Hounslow","LADU","2357","35","42","108","36","2578"
201617,"Hounslow","LADU","2393","37","43","130","43","2646"
201718,"Hounslow","LADU","2359","32","59","122","38","2610"
201819,"Hounslow","LADU","2444","28","46","94","26","2638"
201920,"Hounslow","LADU","2491","23","38","99","41","2692"
202021,"Hounslow","LADU","2720","10","21","92","43","2886"
201516,"Islington","LADU","1178","27","22","81","21","1329"
201617,"Islington","LADU","1228","25","26","78","19","1376"
201718,"Islington","LADU","1202","17","20","93","16","1348"
201819,"Islington","LADU","1232","18","19","80","10","1359"
201920,"Islington","LADU","1282","8","16","102","23","1431"
202021,"Islington","LADU","1302","6","14","87","19","1428"
201516,"Kensington and Chelsea","LADU","674","10","4","36","16","740"
201617,"Kensington and Chelsea","LADU","662","10","11","30","16","729"
201718,"Kensington and Chelsea","LADU","670","4","10","30","14","728"
201819,"Kensington and Chelsea","LADU","651","7","8","35","6","707"
201920,"Kensington and Chelsea","LADU","777","6","8","38","24","853"
202021,"Kensington and Chelsea","LADU","841","6","1","31","10","889"
201516,"Kingston upon Thames","LADU","1411","30","24","68","17","1550"
201617,"Kingston upon Thames","LADU","1369","29","26","39","15","1478"
201718,"Kingston upon Thames","LADU","1392","20","20","35","13","1480"
201819,"Kingston upon Thames","LADU","1402","22","17","44","6","1491"
201920,"Kingston upon Thames","LADU","1415","26","28","31","15","1515"
202021,"Kingston upon Thames","LADU","1634","14","12","43","21","1724"
201516,"Lambeth","LADU","1632","25","21","113","32","1823"
201617,"Lambeth","LADU","1634","34","32","111","23","1834"
201718,"Lambeth","LADU","1701","21","26","102","35","1885"
201819,"Lambeth","LADU","1846","14","36","136","29","2061"
201920,"Lambeth","LADU","1911","16","30","136","46","2139"
202021,"Lambeth","LADU","2024","16","9","111","43","2203"
201516,"Lewisham","LADU","1852","35","26","124","38","2075"
201617,"Lewisham","LADU","2060","31","31","121","42","2285"
201718,"Lewisham","LADU","1969","30","53","112","32","2196"
201819,"Lewisham","LADU","1873","18","30","101","35","2057"
201920,"Lewisham","LADU","1971","12","36","81","49","2149"
202021,"Lewisham","LADU","2093","17","13","69","56","2248"
201516,"Merton","LADU","1340","17","26","74","15","1472"
201617,"Merton","LADU","1268","30","26","66","13","1403"
201718,"Merton","LADU","1273","13","18","54","20","1378"
201819,"Merton","LADU","1274","17","17","41","20","1369"
201920,"Merton","LADU","1304","14","19","53","26","1416"
202021,"Merton","LADU","1428","9","10","47","24","1518"
201516,"Newham","LADU","3163","51","31","192","50","3487"
201617,"Newham","LADU","3175","45","39","174","45","3478"
201718,"Newham","LADU","3196","30","41","170","68","3505"
201819,"Newham","LADU","3409","25","52","169","63","3718"
201920,"Newham","LADU","3590","32","42","189","65","3918"
202021,"Newham","LADU","3812","18","20","147","67","4064"
201516,"Redbridge","LADU","2987","64","33","115","27","3226"
201617,"Redbridge","LADU","3010","41","27","106","26","3210"
201718,"Redbridge","LADU","3075","51","29","117","32","3304"
201819,"Redbridge","LADU","3164","32","34","87","33","3350"
201920,"Redbridge","LADU","3343","22","31","103","30","3529"
202021,"Redbridge","LADU","3505","11","10","101","28","3655"
201516,"Richmond upon Thames","LADU","1156","38","31","79","18","1322"
201617,"Richmond upon Thames","LADU","1211","26","25","68","17","1347"
201718,"Richmond upon Thames","LADU","1210","26","21","58","23","1338"
201819,"Richmond upon Thames","LADU","1304","29","29","68","24","1454"
201920,"Richmond upon Thames","LADU","1417","21","22","63","31","1554"
202021,"Richmond upon Thames","LADU","1524","8","15","58","36","1641"
201516,"Southwark","LADU","2068","37","32","111","43","2291"
201617,"Southwark","LADU","2090","46","45","121","29","2331"
201718,"Southwark","LADU","2077","32","44","103","32","2288"
201819,"Southwark","LADU","2109","38","29","117","40","2333"
201920,"Southwark","LADU","2253","44","33","107","24","2461"
202021,"Southwark","LADU","2460","12","15","84","43","2614"
201516,"Sutton","LADU","2284","68","33","70","12","2467"
201617,"Sutton","LADU","2265","77","37","53","13","2445"
201718,"Sutton","LADU","2325","75","51","68","26","2545"
201819,"Sutton","LADU","2328","58","38","60","14","2498"
201920,"Sutton","LADU","2369","62","35","76","16","2558"
202021,"Sutton","LADU","2514","36","35","55","21","2661"
201516,"Tower Hamlets","LADU","2221","28","30","108","20","2407"
201617,"Tower Hamlets","LADU","2285","39","44","147","27","2542"
201718,"Tower Hamlets","LADU","2378","25","44","120","26","2593"
201819,"Tower Hamlets","LADU","2485","25","35","114","20","2679"
201920,"Tower Hamlets","LADU","2583","18","40","132","20","2793"
202021,"Tower Hamlets","LADU","2803","5","31","133","69","3041"
201516,"Waltham Forest","LADU","2360","37","15","98","30","2540"
201617,"Waltham Forest","LADU","2355","53","39","113","31","2591"
201718,"Waltham Forest","LADU","2344","33","36","92","31","2536"
201819,"Waltham Forest","LADU","2325","30","27","101","47","2530"
201920,"Waltham Forest","LADU","2462","21","25","97","41","2646"
202021,"Waltham Forest","LADU","2576","11","15","95","51","2748"
201516,"Wandsworth","LADU","1530","30","21","79","23","1683"
201617,"Wandsworth","LADU","1441","26","24","73","16","1580"
201718,"Wandsworth","LADU","1514","9","23","51","30","1627"
201819,"Wandsworth","LADU","1501","13","16","70","19","1619"
201920,"Wandsworth","LADU","1568","14","13","82","23","1700"
202021,"Wandsworth","LADU","1685","6","10","58","29","1788"
201516,"Westminster","LADU","1346","16","16","72","21","1471"
201617,"Westminster","LADU","1417","11","15","69","31","1543"
201718,"Westminster","LADU","1397","11","20","57","34","1519"
201819,"Westminster","LADU","1371","7","14","58","24","1474"
201920,"Westminster","LADU","1517","10","18","66","21","1632"
202021,"Westminster","LADU","1596","8","9","56","25","1694"
201516,"Adur","LADU","363","26","19","21","3","432"
201617,"Adur","LADU","360","24","16","29","7","436"
201718,"Adur","LADU","337","18","17","31","7","410"
201819,"Adur","LADU","369","10","13","34","6","432"
201920,"Adur","LADU","381","8","18","25","6","438"
202021,"Adur","LADU","406","7","14","19","3","449"
201516,"Arun","LADU","1134","44","25","66","11","1280"
201617,"Arun","LADU","1090","30","41","70","12","1243"
201718,"Arun","LADU","1062","36","42","67","5","1212"
201819,"Arun","LADU","1044","27","50","58","14","1193"
201920,"Arun","LADU","1087","36","36","50","13","1222"
202021,"Arun","LADU","1104","28","34","63","16","1245"
201516,"Ashford","LADU","1084","53","54","59","5","1255"
201617,"Ashford","LADU","1071","49","47","60","12","1239"
201718,"Ashford","LADU","1056","43","64","53","10","1226"
201819,"Ashford","LADU","1102","54","68","64","10","1298"
201920,"Ashford","LADU","1124","53","57","65","14","1313"
202021,"Ashford","LADU","1165","36","41","46","7","1295"
201516,"Aylesbury Vale","LADU","1797","72","59","52","13","1993"
201617,"Aylesbury Vale","LADU","1742","88","44","38","11","1923"
201718,"Aylesbury Vale","LADU","1714","79","28","47","11","1879"
201819,"Aylesbury Vale","LADU","1784","69","55","51","15","1974"
201920,"Aylesbury Vale","LADU","1798","47","38","57","24","1964"
202021,"Aylesbury Vale","LADU","1947","28","26","56","21","2078"
201516,"Basingstoke and Deane","LADU","1574","103","60","52","9","1798"
201617,"Basingstoke and Deane","LADU","1373","97","63","55","7","1595"
201718,"Basingstoke and Deane","LADU","1259","62","84","57","4","1466"
201819,"Basingstoke and Deane","LADU","1304","86","53","68","9","1520"
201920,"Basingstoke and Deane","LADU","1247","67","72","57","5","1448"
202021,"Basingstoke and Deane","LADU","1311","51","28","67","7","1464"
201516,"Bracknell Forest","LADU","992","47","27","32","3","1101"
201617,"Bracknell Forest","LADU","962","38","21","39","4","1064"
201718,"Bracknell Forest","LADU","967","43","49","42","6","1107"
201819,"Bracknell Forest","LADU","919","33","45","30","6","1033"
201920,"Bracknell Forest","LADU","971","28","55","39","8","1101"
202021,"Bracknell Forest","LADU","1121","17","31","30","9","1208"
201516,"Brighton and Hove","LADU","1933","68","46","107","10","2164"
201617,"Brighton and Hove","LADU","1868","58","49","78","19","2072"
201718,"Brighton and Hove","LADU","1912","68","48","94","14","2136"
201819,"Brighton and Hove","LADU","1899","59","50","89","17","2114"
201920,"Brighton and Hove","LADU","1941","40","50","115","15","2161"
202021,"Brighton and Hove","LADU","2083","26","24","85","18","2236"
201516,"Canterbury","LADU","1355","55","24","73","10","1517"
201617,"Canterbury","LADU","1308","51","25","58","17","1459"
201718,"Canterbury","LADU","1269","54","42","51","13","1429"
201819,"Canterbury","LADU","1285","39","49","67","17","1457"
201920,"Canterbury","LADU","1299","46","46","74","20","1485"
202021,"Canterbury","LADU","1303","26","22","51","16","1418"
201516,"Cherwell","LADU","1093","72","65","52","4","1286"
201617,"Cherwell","LADU","1052","57","44","63","7","1223"
201718,"Cherwell","LADU","1049","48","36","48","11","1192"
201819,"Cherwell","LADU","992","66","55","53","13","1179"
201920,"Cherwell","LADU","1021","72","60","68","15","1236"
202021,"Cherwell","LADU","1091","35","43","53","8","1230"
201516,"Chichester","LADU","897","22","26","39","12","996"
201617,"Chichester","LADU","828","32","30","25","4","919"
201718,"Chichester","LADU","832","29","32","18","10","921"
201819,"Chichester","LADU","812","16","21","28","5","882"
201920,"Chichester","LADU","850","28","41","38","12","969"
202021,"Chichester","LADU","830","16","24","56","13","939"
201516,"Chiltern","LADU","1262","49","19","32","7","1369"
201617,"Chiltern","LADU","1233","34","19","28","4","1318"
201718,"Chiltern","LADU","1205","42","32","25","13","1317"
201819,"Chiltern","LADU","1192","25","22","26","8","1273"
201920,"Chiltern","LADU","1262","30","26","31","8","1357"
202021,"Chiltern","LADU","1313","32","25","33","7","1410"
201516,"Crawley","LADU","1069","43","40","62","15","1229"
201617,"Crawley","LADU","1131","37","44","72","9","1293"
201718,"Crawley","LADU","1041","56","43","56","17","1213"
201819,"Crawley","LADU","1028","24","48","48","16","1164"
201920,"Crawley","LADU","1105","26","41","63","18","1253"
202021,"Crawley","LADU","1192","14","24","56","19","1305"
201516,"Dartford","LADU","1220","40","42","62","3","1367"
201617,"Dartford","LADU","1206","55","37","52","8","1358"
201718,"Dartford","LADU","1239","47","45","43","6","1380"
201819,"Dartford","LADU","1233","40","33","48","8","1362"
201920,"Dartford","LADU","1301","39","41","51","10","1442"
202021,"Dartford","LADU","1409","32","29","62","15","1547"
201516,"Dover","LADU","1140","57","25","75","8","1305"
201617,"Dover","LADU","1072","50","40","57","17","1236"
201718,"Dover","LADU","1072","35","37","64","16","1224"
201819,"Dover","LADU","1052","38","29","73","16","1208"
201920,"Dover","LADU","1035","37","22","56","10","1160"
202021,"Dover","LADU","1050","24","24","70","14","1182"
201516,"East Hampshire","LADU","1026","48","39","59","9","1181"
201617,"East Hampshire","LADU","1055","41","37","40","3","1176"
201718,"East Hampshire","LADU","1034","43","36","39","4","1156"
201819,"East Hampshire","LADU","1069","39","43","40","3","1194"
201920,"East Hampshire","LADU","1105","39","44","57","3","1248"
202021,"East Hampshire","LADU","1226","28","45","46","9","1354"
201516,"Eastbourne","LADU","791","57","29","75","8","960"
201617,"Eastbourne","LADU","745","45","21","63","7","881"
201718,"Eastbourne","LADU","748","32","41","92","7","920"
201819,"Eastbourne","LADU","757","28","35","71","9","900"
201920,"Eastbourne","LADU","803","35","34","64","11","947"
202021,"Eastbourne","LADU","835","14","32","63","9","953"
201516,"Eastleigh","LADU","1296","89","39","53","12","1489"
201617,"Eastleigh","LADU","1235","79","53","70","12","1449"
201718,"Eastleigh","LADU","1194","53","49","62","2","1360"
201819,"Eastleigh","LADU","1189","61","53","82","6","1391"
201920,"Eastleigh","LADU","1237","46","56","71","7","1417"
202021,"Eastleigh","LADU","1284","40","42","66","11","1443"
201516,"Elmbridge","LADU","722","33","24","49","6","834"
201617,"Elmbridge","LADU","711","21","29","32","6","799"
201718,"Elmbridge","LADU","691","27","31","28","8","785"
201819,"Elmbridge","LADU","723","23","23","28","2","799"
201920,"Elmbridge","LADU","774","14","24","17","3","832"
202021,"Elmbridge","LADU","794","5","14","19","15","847"
201516,"Epsom and Ewell","LADU","977","40","15","31","8","1071"
201617,"Epsom and Ewell","LADU","946","40","18","20","7","1031"
201718,"Epsom and Ewell","LADU","942","36","20","19","6","1023"
201819,"Epsom and Ewell","LADU","924","20","16","28","11","999"
201920,"Epsom and Ewell","LADU","926","32","24","26","9","1017"
202021,"Epsom and Ewell","LADU","1021","21","13","22","13","1090"
201516,"Fareham","LADU","1111","59","37","43","5","1255"
201617,"Fareham","LADU","1067","55","37","42","2","1203"
201718,"Fareham","LADU","1072","61","30","54","7","1224"
201819,"Fareham","LADU","957","57","44","56","2","1116"
201920,"Fareham","LADU","1031","56","45","53","8","1193"
202021,"Fareham","LADU","1050","48","33","47","6","1184"
201516,"Folkestone and Hythe","LADU","889","33","31","65","8","1026"
201617,"Folkestone and Hythe","LADU","852","54","21","49","12","988"
201718,"Folkestone and Hythe","LADU","785","41","27","43","10","906"
201819,"Folkestone and Hythe","LADU","800","27","41","41","7","916"
201920,"Folkestone and Hythe","LADU","831","26","28","60","6","951"
202021,"Folkestone and Hythe","LADU","869","27","30","51","12","989"
201516,"Gosport","LADU","674","53","22","48","10","807"
201617,"Gosport","LADU","639","45","24","47","11","766"
201718,"Gosport","LADU","620","23","27","42","4","716"
201819,"Gosport","LADU","543","26","27","36","3","635"
201920,"Gosport","LADU","584","23","34","72","8","721"
202021,"Gosport","LADU","611","17","18","28","11","685"
201516,"Gravesham","LADU","1036","41","30","70","10","1187"
201617,"Gravesham","LADU","1019","41","25","49","5","1139"
201718,"Gravesham","LADU","999","41","25","54","4","1123"
201819,"Gravesham","LADU","1024","35","42","59","16","1176"
201920,"Gravesham","LADU","1013","29","35","66","8","1151"
202021,"Gravesham","LADU","1168","17","20","49","7","1261"
201516,"Guildford","LADU","1142","31","46","43","6","1268"
201617,"Guildford","LADU","1133","44","58","45","7","1287"
201718,"Guildford","LADU","1113","46","37","46","10","1252"
201819,"Guildford","LADU","1062","29","35","48","10","1184"
201920,"Guildford","LADU","1151","23","39","48","6","1267"
202021,"Guildford","LADU","1159","27","23","40","16","1265"
201516,"Hart","LADU","951","35","35","33","4","1058"
201617,"Hart","LADU","930","37","27","23","9","1026"
201718,"Hart","LADU","925","47","38","33","8","1051"
201819,"Hart","LADU","901","36","34","28","8","1007"
201920,"Hart","LADU","912","33","27","45","7","1024"
202021,"Hart","LADU","977","27","18","29","5","1056"
201516,"Hastings","LADU","724","17","14","71","6","832"
201617,"Hastings","LADU","662","19","16","74","2","773"
201718,"Hastings","LADU","605","10","27","56","4","702"
201819,"Hastings","LADU","601","12","22","51","2","688"
201920,"Hastings","LADU","548","11","19","57","9","644"
202021,"Hastings","LADU","620","13","16","50","2","701"
201516,"Havant","LADU","1009","90","70","86","5","1260"
201617,"Havant","LADU","945","64","43","76","10","1138"
201718,"Havant","LADU","964","79","59","49","4","1155"
201819,"Havant","LADU","885","63","54","68","8","1078"
201920,"Havant","LADU","896","66","48","73","6","1089"
202021,"Havant","LADU","901","44","47","74","7","1073"
201516,"Horsham","LADU","1234","44","46","52","6","1382"
201617,"Horsham","LADU","1304","39","29","50","14","1436"
201718,"Horsham","LADU","1225","42","36","40","14","1357"
201819,"Horsham","LADU","1206","26","36","38","7","1313"
201920,"Horsham","LADU","1290","35","57","52","13","1447"
202021,"Horsham","LADU","1337","26","28","44","18","1453"
201516,"Isle of Wight","LADU","1184","55","45","68","9","1361"
201617,"Isle of Wight","LADU","1113","39","64","60","2","1278"
201718,"Isle of Wight","LADU","1082","41","45","57","11","1236"
201819,"Isle of Wight","LADU","917","47","36","48","2","1050"
201920,"Isle of Wight","LADU","1013","35","47","50","3","1148"
202021,"Isle of Wight","LADU","1083","17","20","39","9","1168"
201516,"Lewes","LADU","896","45","30","52","4","1027"
201617,"Lewes","LADU","859","28","33","53","1","974"
201718,"Lewes","LADU","855","40","26","52","7","980"
201819,"Lewes","LADU","853","36","25","50","4","968"
201920,"Lewes","LADU","822","33","35","72","7","969"
202021,"Lewes","LADU","887","17","15","51","10","980"
201516,"Maidstone","LADU","1600","59","55","74","7","1795"
201617,"Maidstone","LADU","1590","54","43","68","9","1764"
201718,"Maidstone","LADU","1596","58","61","50","5","1770"
201819,"Maidstone","LADU","1547","56","66","51","3","1723"
201920,"Maidstone","LADU","1635","49","48","66","8","1806"
202021,"Maidstone","LADU","1732","39","55","64","21","1911"
201516,"Medway","LADU","2717","101","65","171","19","3073"
201617,"Medway","LADU","2542","100","65","164","21","2892"
201718,"Medway","LADU","2469","107","83","142","46","2847"
201819,"Medway","LADU","2472","117","75","115","41","2820"
201920,"Medway","LADU","2660","81","77","143","35","2996"
202021,"Medway","LADU","2737","47","81","115","34","3014"
201516,"Mid Sussex","LADU","1413","47","43","52","12","1567"
201617,"Mid Sussex","LADU","1346","67","44","47","7","1511"
201718,"Mid Sussex","LADU","1285","69","49","45","6","1454"
201819,"Mid Sussex","LADU","1306","36","52","30","7","1431"
201920,"Mid Sussex","LADU","1324","55","42","48","18","1487"
202021,"Mid Sussex","LADU","1414","34","26","46","12","1532"
201516,"Milton Keynes","LADU","2463","109","105","138","31","2846"
201617,"Milton Keynes","LADU","2393","96","99","138","16","2742"
201718,"Milton Keynes","LADU","2474","66","90","126","23","2779"
201819,"Milton Keynes","LADU","2392","65","107","126","14","2704"
201920,"Milton Keynes","LADU","2540","66","89","135","23","2853"
202021,"Milton Keynes","LADU","2769","37","70","145","37","3058"
201516,"Mole Valley","LADU","659","35","16","16","2","728"
201617,"Mole Valley","LADU","614","17","19","22","3","675"
201718,"Mole Valley","LADU","532","21","23","22","5","603"
201819,"Mole Valley","LADU","571","17","22","24","7","641"
201920,"Mole Valley","LADU","598","25","19","20","4","666"
202021,"Mole Valley","LADU","670","15","12","13","7","717"
201516,"New Forest","LADU","1452","81","68","77","11","1689"
201617,"New Forest","LADU","1290","111","67","69","14","1551"
201718,"New Forest","LADU","1306","94","77","70","7","1554"
201819,"New Forest","LADU","1309","85","58","63","11","1526"
201920,"New Forest","LADU","1371","77","68","59","13","1588"
202021,"New Forest","LADU","1410","38","39","63","18","1568"
201516,"Oxford","LADU","865","21","20","53","18","977"
201617,"Oxford","LADU","775","37","24","60","14","910"
201718,"Oxford","LADU","792","18","35","51","11","907"
201819,"Oxford","LADU","760","30","49","58","18","915"
201920,"Oxford","LADU","850","27","31","50","7","965"
202021,"Oxford","LADU","889","23","26","73","20","1031"
201516,"Portsmouth","LADU","1332","88","65","138","15","1638"
201617,"Portsmouth","LADU","1330","100","87","128","17","1662"
201718,"Portsmouth","LADU","1287","84","67","102","17","1557"
201819,"Portsmouth","LADU","1298","75","61","142","23","1599"
201920,"Portsmouth","LADU","1273","73","68","145","26","1585"
202021,"Portsmouth","LADU","1529","62","49","109","19","1768"
201516,"Reading","LADU","1027","38","33","37","7","1142"
201617,"Reading","LADU","1015","49","27","60","8","1159"
201718,"Reading","LADU","990","27","43","44","13","1117"
201819,"Reading","LADU","922","29","33","64","5","1053"
201920,"Reading","LADU","999","21","35","45","9","1109"
202021,"Reading","LADU","1213","19","26","60","15","1333"
201516,"Reigate and Banstead","LADU","1128","41","28","47","11","1255"
201617,"Reigate and Banstead","LADU","1069","47","37","55","8","1216"
201718,"Reigate and Banstead","LADU","1019","40","30","35","21","1145"
201819,"Reigate and Banstead","LADU","1019","25","36","41","11","1132"
201920,"Reigate and Banstead","LADU","1103","29","34","48","13","1227"
202021,"Reigate and Banstead","LADU","1186","19","18","42","19","1284"
201516,"Rother","LADU","873","33","16","46","2","970"
201617,"Rother","LADU","841","31","27","48","6","953"
201718,"Rother","LADU","824","27","17","44","3","915"
201819,"Rother","LADU","763","25","26","39","5","858"
201920,"Rother","LADU","798","25","15","54","4","896"
202021,"Rother","LADU","795","27","17","41","2","882"
201516,"Runnymede","LADU","751","40","36","40","10","877"
201617,"Runnymede","LADU","735","28","40","38","6","847"
201718,"Runnymede","LADU","742","26","35","32","10","845"
201819,"Runnymede","LADU","709","26","33","32","7","807"
201920,"Runnymede","LADU","756","26","27","20","12","841"
202021,"Runnymede","LADU","778","15","17","30","12","852"
201516,"Rushmoor","LADU","571","33","35","37","4","680"
201617,"Rushmoor","LADU","548","28","35","30","7","648"
201718,"Rushmoor","LADU","504","29","26","31","3","593"
201819,"Rushmoor","LADU","484","18","28","26","9","565"
201920,"Rushmoor","LADU","514","14","38","29","6","601"
202021,"Rushmoor","LADU","558","14","13","32","6","623"
201516,"Sevenoaks","LADU","313","25","20","27","4","389"
201617,"Sevenoaks","LADU","287","22","16","28","1","354"
201718,"Sevenoaks","LADU","254","17","17","16","3","307"
201819,"Sevenoaks","LADU","330","14","22","22","4","392"
201920,"Sevenoaks","LADU","374","18","17","23","6","438"
202021,"Sevenoaks","LADU","412","14","16","20","6","468"
201516,"Slough","LADU","1481","35","27","41","18","1602"
201617,"Slough","LADU","1504","32","19","43","15","1613"
201718,"Slough","LADU","1518","26","18","47","16","1625"
201819,"Slough","LADU","1527","23","26","68","10","1654"
201920,"Slough","LADU","1703","18","29","55","23","1828"
202021,"Slough","LADU","1807","11","23","72","18","1931"
201516,"South Bucks","LADU","511","11","5","10","2","539"
201617,"South Bucks","LADU","481","19","11","14","13","538"
201718,"South Bucks","LADU","535","15","12","14","4","580"
201819,"South Bucks","LADU","570","15","10","22","5","622"
201920,"South Bucks","LADU","572","12","11","33","4","632"
202021,"South Bucks","LADU","522","2","6","14","0","544"
201516,"South Oxfordshire","LADU","1345","113","55","65","8","1586"
201617,"South Oxfordshire","LADU","1305","88","58","63","5","1519"
201718,"South Oxfordshire","LADU","1233","59","55","73","15","1435"
201819,"South Oxfordshire","LADU","1306","77","65","55","14","1517"
201920,"South Oxfordshire","LADU","1365","54","53","65","10","1547"
202021,"South Oxfordshire","LADU","1421","44","49","57","11","1582"
201516,"Southampton","LADU","1566","77","77","128","11","1859"
201617,"Southampton","LADU","1522","98","88","162","38","1908"
201718,"Southampton","LADU","1502","75","86","122","15","1800"
201819,"Southampton","LADU","1555","67","78","121","19","1840"
201920,"Southampton","LADU","1575","62","102","138","21","1898"
202021,"Southampton","LADU","1815","41","69","152","18","2095"
201516,"Spelthorne","LADU","904","46","44","50","11","1055"
201617,"Spelthorne","LADU","872","43","31","38","10","994"
201718,"Spelthorne","LADU","771","53","55","42","5","926"
201819,"Spelthorne","LADU","746","39","36","45","9","875"
201920,"Spelthorne","LADU","885","46","30","46","4","1011"
202021,"Spelthorne","LADU","905","16","18","34","13","986"
201516,"Surrey Heath","LADU","736","27","24","22","7","816"
201617,"Surrey Heath","LADU","701","21","25","25","2","774"
201718,"Surrey Heath","LADU","699","17","19","14","6","755"
201819,"Surrey Heath","LADU","698","16","16","23","6","759"
201920,"Surrey Heath","LADU","698","11","30","24","9","772"
202021,"Surrey Heath","LADU","747","18","17","17","11","810"
201516,"Swale","LADU","1291","70","38","98","6","1503"
201617,"Swale","LADU","1263","75","56","97","8","1499"
201718,"Swale","LADU","1215","65","71","56","7","1414"
201819,"Swale","LADU","1203","62","50","99","20","1434"
201920,"Swale","LADU","1224","58","65","91","14","1452"
202021,"Swale","LADU","1321","27","53","81","18","1500"
201516,"Tandridge","LADU","635","31","14","29","6","715"
201617,"Tandridge","LADU","646","25","21","23","5","720"
201718,"Tandridge","LADU","583","28","20","32","6","669"
201819,"Tandridge","LADU","603","19","18","32","4","676"
201920,"Tandridge","LADU","572","20","20","30","8","650"
202021,"Tandridge","LADU","627","15","7","30","11","690"
201516,"Test Valley","LADU","950","58","49","55","4","1116"
201617,"Test Valley","LADU","925","57","43","45","8","1078"
201718,"Test Valley","LADU","870","41","44","48","5","1008"
201819,"Test Valley","LADU","877","40","39","53","3","1012"
201920,"Test Valley","LADU","897","42","36","50","7","1032"
202021,"Test Valley","LADU","922","17","40","47","10","1036"
201516,"Thanet","LADU","1202","51","42","106","6","1407"
201617,"Thanet","LADU","1209","58","48","111","16","1442"
201718,"Thanet","LADU","1116","31","44","115","21","1327"
201819,"Thanet","LADU","1136","34","47","86","20","1323"
201920,"Thanet","LADU","1106","29","45","90","15","1285"
202021,"Thanet","LADU","1216","27","34","102","25","1404"
201516,"Tonbridge and Malling","LADU","1355","70","56","81","5","1567"
201617,"Tonbridge and Malling","LADU","1307","58","61","62","5","1493"
201718,"Tonbridge and Malling","LADU","1269","45","67","57","4","1442"
201819,"Tonbridge and Malling","LADU","1289","36","52","70","9","1456"
201920,"Tonbridge and Malling","LADU","1351","42","57","67","5","1522"
202021,"Tonbridge and Malling","LADU","1366","18","37","51","13","1485"
201516,"Tunbridge Wells","LADU","1307","47","31","44","6","1435"
201617,"Tunbridge Wells","LADU","1246","31","28","41","13","1359"
201718,"Tunbridge Wells","LADU","1332","29","30","40","6","1437"
201819,"Tunbridge Wells","LADU","1287","35","32","49","7","1410"
201920,"Tunbridge Wells","LADU","1333","22","45","49","15","1464"
202021,"Tunbridge Wells","LADU","1405","10","24","39","15","1493"
201516,"Vale of White Horse","LADU","866","81","48","41","3","1039"
201617,"Vale of White Horse","LADU","913","75","40","37","4","1069"
201718,"Vale of White Horse","LADU","946","65","39","45","14","1109"
201819,"Vale of White Horse","LADU","924","64","53","40","9","1090"
201920,"Vale of White Horse","LADU","912","87","46","48","14","1107"
202021,"Vale of White Horse","LADU","986","55","34","58","17","1150"
201516,"Waverley","LADU","1099","48","45","50","4","1246"
201617,"Waverley","LADU","1090","29","34","50","6","1209"
201718,"Waverley","LADU","1049","30","39","50","9","1177"
201819,"Waverley","LADU","1001","25","33","44","10","1113"
201920,"Waverley","LADU","1041","20","33","32","12","1138"
202021,"Waverley","LADU","1124","29","27","46","11","1237"
201516,"Wealden","LADU","1144","47","29","54","3","1277"
201617,"Wealden","LADU","1086","55","50","52","4","1247"
201718,"Wealden","LADU","1051","39","44","56","3","1193"
201819,"Wealden","LADU","1018","32","44","56","6","1156"
201920,"Wealden","LADU","1066","38","41","67","5","1217"
202021,"Wealden","LADU","1085","19","19","50","8","1181"
201516,"West Berkshire","LADU","1685","75","57","45","8","1870"
201617,"West Berkshire","LADU","1627","97","71","66","12","1873"
201718,"West Berkshire","LADU","1548","83","74","49","3","1757"
201819,"West Berkshire","LADU","1483","88","66","49","14","1700"
201920,"West Berkshire","LADU","1592","85","76","60","8","1821"
202021,"West Berkshire","LADU","1668","42","49","52","13","1824"
201516,"West Oxfordshire","LADU","1066","79","37","36","2","1220"
201617,"West Oxfordshire","LADU","1006","82","46","33","6","1173"
201718,"West Oxfordshire","LADU","1058","72","43","34","9","1216"
201819,"West Oxfordshire","LADU","930","65","60","26","12","1093"
201920,"West Oxfordshire","LADU","1037","73","58","34","8","1210"
202021,"West Oxfordshire","LADU","1064","52","49","51","17","1233"
201516,"Winchester","LADU","1101","34","36","39","8","1218"
201617,"Winchester","LADU","1088","40","21","44","4","1197"
201718,"Winchester","LADU","1081","32","25","31","4","1173"
201819,"Winchester","LADU","1066","27","33","47","6","1179"
201920,"Winchester","LADU","1062","23","29","52","4","1170"
202021,"Winchester","LADU","1122","22","16","41","12","1213"
201516,"Windsor and Maidenhead","LADU","1364","52","29","53","17","1515"
201617,"Windsor and Maidenhead","LADU","1303","43","36","43","23","1448"
201718,"Windsor and Maidenhead","LADU","1356","42","38","51","29","1516"
201819,"Windsor and Maidenhead","LADU","1331","30","37","48","29","1475"
201920,"Windsor and Maidenhead","LADU","1334","45","28","54","17","1478"
202021,"Windsor and Maidenhead","LADU","1448","17","25","46","22","1558"
201516,"Woking","LADU","745","20","30","42","9","846"
201617,"Woking","LADU","693","28","30","23","5","779"
201718,"Woking","LADU","770","21","20","23","11","845"
201819,"Woking","LADU","718","17","24","31","7","797"
201920,"Woking","LADU","829","10","24","24","2","889"
202021,"Woking","LADU","839","21","14","25","14","913"
201516,"Wokingham","LADU","1465","60","31","53","5","1614"
201617,"Wokingham","LADU","1384","81","38","55","13","1571"
201718,"Wokingham","LADU","1463","63","42","37","11","1616"
201819,"Wokingham","LADU","1473","51","34","44","10","1612"
201920,"Wokingham","LADU","1555","50","34","61","16","1716"
202021,"Wokingham","LADU","1523","36","29","57","13","1658"
201516,"Worthing","LADU","992","33","38","53","9","1125"
201617,"Worthing","LADU","986","51","32","55","11","1135"
201718,"Worthing","LADU","957","34","20","42","16","1069"
201819,"Worthing","LADU","887","27","41","47","3","1005"
201920,"Worthing","LADU","933","26","35","46","5","1045"
202021,"Worthing","LADU","1041","17","24","48","10","1140"
201516,"Wycombe","LADU","1545","57","36","58","8","1704"
201617,"Wycombe","LADU","1565","63","36","46","7","1717"
201718,"Wycombe","LADU","1554","46","36","49","7","1692"
201819,"Wycombe","LADU","1525","39","43","56","20","1683"
201920,"Wycombe","LADU","1591","33","28","41","27","1720"
202021,"Wycombe","LADU","1702","13","24","58","22","1819"
201516,"Bath and North East Somerset","LADU","1723","113","32","104","12","1984"
201617,"Bath and North East Somerset","LADU","1735","100","56","76","10","1977"
201718,"Bath and North East Somerset","LADU","1699","102","63","84","6","1954"
201819,"Bath and North East Somerset","LADU","1749","111","63","90","18","2031"
201920,"Bath and North East Somerset","LADU","1790","118","64","96","27","2095"
202021,"Bath and North East Somerset","LADU","1913","73","53","84","7","2130"
201516,"Bournemouth","LADU","1384","67","47","91","9","1598"
201617,"Bournemouth","LADU","1334","71","57","75","12","1549"
201718,"Bournemouth","LADU","1367","66","50","55","16","1554"
201819,"Bournemouth","LADU","1262","52","66","68","12","1460"
201920,"Bournemouth, Christchurch and Poole","LADU","3012","145","143","162","27","3489"
202021,"Bournemouth, Christchurch and Poole","LADU","3164","96","77","139","32","3508"
201516,"Bristol, City of","LADU","2557","144","105","199","33","3038"
201617,"Bristol, City of","LADU","2496","160","143","216","40","3055"
201718,"Bristol, City of","LADU","2639","120","157","205","47","3168"
201819,"Bristol, City of","LADU","2627","98","111","179","23","3038"
201920,"Bristol, City of","LADU","2837","116","100","197","36","3286"
202021,"Bristol, City of","LADU","2998","73","70","214","28","3383"
201516,"Cheltenham","LADU","729","29","22","45","5","830"
201617,"Cheltenham","LADU","779","30","17","33","3","862"
201718,"Cheltenham","LADU","694","29","25","36","5","789"
201819,"Cheltenham","LADU","713","30","39","38","4","824"
201920,"Cheltenham","LADU","751","31","31","42","5","860"
202021,"Cheltenham","LADU","776","13","17","46","4","856"
201516,"Christchurch","LADU","508","38","18","16","7","587"
201617,"Christchurch","LADU","501","41","21","32","2","597"
201718,"Christchurch","LADU","513","24","26","18","2","583"
201819,"Christchurch","LADU","499","28","16","21","2","566"
201516,"Cornwall","LADU","4726","295","144","311","39","5515"
201617,"Cornwall","LADU","4668","260","131","291","33","5383"
201718,"Cornwall","LADU","4370","239","153","296","30","5088"
201819,"Cornwall","LADU","4334","274","157","285","30","5080"
201920,"Cornwall","LADU","4363","232","152","280","26","5053"
202021,"Cornwall","LADU","4543","186","117","293","44","5183"
201516,"Cotswold","LADU","844","47","30","30","7","958"
201617,"Cotswold","LADU","864","41","30","33","6","974"
201718,"Cotswold","LADU","847","37","39","40","5","968"
201819,"Cotswold","LADU","787","37","42","35","7","908"
201920,"Cotswold","LADU","901","34","31","39","4","1009"
202021,"Cotswold","LADU","892","20","19","27","6","964"
201920,"Dorset","LADU","2977","168","126","145","25","3441"
202021,"Dorset","LADU","3093","125","95","144","38","3495"
201516,"East Devon","LADU","1143","75","32","47","4","1301"
201617,"East Devon","LADU","1122","79","32","50","7","1290"
201718,"East Devon","LADU","1036","80","45","53","5","1219"
201819,"East Devon","LADU","1042","63","35","53","4","1197"
201920,"East Devon","LADU","1027","69","50","57","4","1207"
202021,"East Devon","LADU","1094","54","27","54","9","1238"
201516,"East Dorset","LADU","474","46","29","18","5","572"
201617,"East Dorset","LADU","473","40","15","16","4","548"
201718,"East Dorset","LADU","471","35","19","23","2","550"
201819,"East Dorset","LADU","422","34","23","16","4","499"
201516,"Exeter","LADU","769","57","43","49","5","923"
201617,"Exeter","LADU","764","63","47","59","4","937"
201718,"Exeter","LADU","719","75","37","38","13","882"
201819,"Exeter","LADU","767","60","40","59","5","931"
201920,"Exeter","LADU","775","52","42","54","6","929"
202021,"Exeter","LADU","818","40","34","56","9","957"
201516,"Forest of Dean","LADU","714","72","39","62","18","905"
201617,"Forest of Dean","LADU","698","63","40","52","16","869"
201718,"Forest of Dean","LADU","605","69","40","44","11","769"
201819,"Forest of Dean","LADU","561","47","45","46","7","706"
201920,"Forest of Dean","LADU","579","57","55","55","22","768"
202021,"Forest of Dean","LADU","645","39","32","35","13","764"
201516,"Gloucester","LADU","1259","64","52","84","4","1463"
201617,"Gloucester","LADU","1178","58","64","67","10","1377"
201718,"Gloucester","LADU","1186","52","53","67","4","1362"
201819,"Gloucester","LADU","1175","62","58","67","5","1367"
201920,"Gloucester","LADU","1202","45","73","61","7","1388"
202021,"Gloucester","LADU","1277","42","36","59","15","1429"
201516,"Isles of Scilly","LADU","17","1","0","1","0","19"
201617,"Isles of Scilly","LADU","23","0","0","0","0","23"
201718,"Isles of Scilly","LADU","14","2","1","1","1","19"
201819,"Isles of Scilly","LADU","12","0","1","2","0","15"
201920,"Isles of Scilly","LADU","10","2","2","0","0","14"
202021,"Isles of Scilly","LADU","17","0","0","1","0","18"
201516,"Mendip","LADU","825","52","17","49","5","948"
201617,"Mendip","LADU","804","63","32","42","7","948"
201718,"Mendip","LADU","687","64","26","30","3","810"
201819,"Mendip","LADU","735","55","28","26","9","853"
201920,"Mendip","LADU","725","52","38","34","6","855"
202021,"Mendip","LADU","794","35","27","50","8","914"
201516,"Mid Devon","LADU","716","57","22","50","4","849"
201617,"Mid Devon","LADU","651","39","14","30","6","740"
201718,"Mid Devon","LADU","603","67","29","26","8","733"
201819,"Mid Devon","LADU","607","44","23","33","6","713"
201920,"Mid Devon","LADU","657","61","27","45","2","792"
202021,"Mid Devon","LADU","641","40","19","43","4","747"
201516,"North Devon","LADU","938","50","27","52","5","1072"
201617,"North Devon","LADU","875","68","31","34","3","1011"
201718,"North Devon","LADU","829","79","26","55","3","992"
201819,"North Devon","LADU","808","66","38","45","3","960"
201920,"North Devon","LADU","848","35","39","36","10","968"
202021,"North Devon","LADU","904","58","30","32","1","1025"
201516,"North Dorset","LADU","621","44","9","23","3","700"
201617,"North Dorset","LADU","586","36","30","34","4","690"
201718,"North Dorset","LADU","544","30","19","18","4","615"
201819,"North Dorset","LADU","572","34","19","15","8","648"
201516,"North Somerset","LADU","1939","101","55","89","7","2191"
201617,"North Somerset","LADU","1874","93","70","96","11","2144"
201718,"North Somerset","LADU","1831","100","43","78","8","2060"
201819,"North Somerset","LADU","1829","95","50","64","12","2050"
201920,"North Somerset","LADU","1858","80","54","84","16","2092"
202021,"North Somerset","LADU","1997","56","40","62","12","2167"
201516,"Plymouth","LADU","2297","225","40","101","5","2668"
201617,"Plymouth","LADU","2259","164","55","88","6","2572"
201718,"Plymouth","LADU","2110","190","49","93","14","2456"
201819,"Plymouth","LADU","2040","218","66","91","7","2422"
201920,"Plymouth","LADU","2114","191","49","107","13","2474"
202021,"Plymouth","LADU","2163","185","64","116","21","2549"
201516,"Poole","LADU","1309","82","39","81","9","1520"
201617,"Poole","LADU","1202","88","64","58","7","1419"
201718,"Poole","LADU","1146","65","59","43","5","1318"
201819,"Poole","LADU","1113","70","54","46","8","1291"
201516,"Purbeck","LADU","355","33","18","18","0","424"
201617,"Purbeck","LADU","354","22","15","26","4","421"
201718,"Purbeck","LADU","358","23","21","19","1","422"
201819,"Purbeck","LADU","349","27","25","20","1","422"
201516,"Sedgemoor","LADU","1087","65","25","41","3","1221"
201617,"Sedgemoor","LADU","1020","75","33","67","6","1201"
201718,"Sedgemoor","LADU","1067","63","44","47","6","1227"
201819,"Sedgemoor","LADU","949","62","23","50","4","1088"
201920,"Sedgemoor","LADU","1041","74","49","45","9","1218"
202021,"Sedgemoor","LADU","1069","58","26","45","5","1203"
201920,"Somerset West and Taunton","LADU","1076","91","57","65","4","1293"
202021,"Somerset West and Taunton","LADU","1131","64","34","62","7","1298"
201516,"South Gloucestershire","LADU","2437","222","91","124","17","2891"
201617,"South Gloucestershire","LADU","2250","234","107","113","16","2720"
201718,"South Gloucestershire","LADU","2109","205","102","102","28","2546"
201819,"South Gloucestershire","LADU","2031","191","121","107","12","2462"
201920,"South Gloucestershire","LADU","2118","178","102","106","32","2536"
202021,"South Gloucestershire","LADU","2170","132","71","101","32","2506"
201516,"South Hams","LADU","761","48","10","27","4","850"
201617,"South Hams","LADU","742","57","13","24","3","839"
201718,"South Hams","LADU","682","63","17","29","3","794"
201819,"South Hams","LADU","669","51","25","21","6","772"
201920,"South Hams","LADU","734","47","18","24","6","829"
202021,"South Hams","LADU","714","44","17","27","5","807"
201516,"South Somerset","LADU","1315","152","41","78","11","1597"
201617,"South Somerset","LADU","1374","137","43","49","6","1609"
201718,"South Somerset","LADU","1291","120","37","56","6","1510"
201819,"South Somerset","LADU","1143","116","51","55","9","1374"
201920,"South Somerset","LADU","1242","114","49","68","20","1493"
202021,"South Somerset","LADU","1266","78","32","65","6","1447"
201516,"Stroud","LADU","1034","69","19","43","2","1167"
201617,"Stroud","LADU","996","58","31","27","5","1117"
201718,"Stroud","LADU","994","79","30","35","0","1138"
201819,"Stroud","LADU","935","47","33","26","4","1045"
201920,"Stroud","LADU","1040","52","33","49","4","1178"
202021,"Stroud","LADU","1043","33","38","27","5","1146"
201516,"Swindon","LADU","1873","84","62","67","11","2097"
201617,"Swindon","LADU","1784","133","62","68","7","2054"
201718,"Swindon","LADU","1743","75","60","77","19","1974"
201819,"Swindon","LADU","1689","84","66","100","21","1960"
201920,"Swindon","LADU","1803","68","72","78","29","2050"
202021,"Swindon","LADU","1907","52","37","100","30","2126"
201516,"Taunton Deane","LADU","963","74","28","60","2","1127"
201617,"Taunton Deane","LADU","938","67","41","43","5","1094"
201718,"Taunton Deane","LADU","869","51","51","41","7","1019"
201819,"Taunton Deane","LADU","852","65","41","68","6","1032"
201516,"Teignbridge","LADU","1015","70","29","48","1","1163"
201617,"Teignbridge","LADU","971","60","37","49","4","1121"
201718,"Teignbridge","LADU","929","43","38","45","2","1057"
201819,"Teignbridge","LADU","822","58","34","53","4","971"
201920,"Teignbridge","LADU","898","53","35","49","5","1040"
202021,"Teignbridge","LADU","933","43","29","55","3","1063"
201516,"Tewkesbury","LADU","934","79","67","73","10","1163"
201617,"Tewkesbury","LADU","894","80","37","62","10","1083"
201718,"Tewkesbury","LADU","814","86","61","72","5","1038"
201819,"Tewkesbury","LADU","863","87","67","43","4","1064"
201920,"Tewkesbury","LADU","882","104","57","46","7","1096"
202021,"Tewkesbury","LADU","940","44","49","43","9","1085"
201516,"Torbay","LADU","1295","44","28","73","8","1448"
201617,"Torbay","LADU","1271","52","37","63","12","1435"
201718,"Torbay","LADU","1142","37","18","52","6","1255"
201819,"Torbay","LADU","1196","54","36","54","11","1351"
201920,"Torbay","LADU","1233","37","28","60","12","1370"
202021,"Torbay","LADU","1418","40","24","65","20","1567"
201516,"Torridge","LADU","462","45","18","28","2","555"
201617,"Torridge","LADU","458","42","12","21","1","534"
201718,"Torridge","LADU","410","37","13","19","1","480"
201819,"Torridge","LADU","387","48","12","28","3","478"
201920,"Torridge","LADU","436","23","20","33","2","514"
202021,"Torridge","LADU","417","30","19","24","1","491"
201516,"West Devon","LADU","379","30","11","17","2","439"
201617,"West Devon","LADU","345","25","14","13","4","401"
201718,"West Devon","LADU","360","26","16","21","4","427"
201819,"West Devon","LADU","335","31","14","23","0","403"
201920,"West Devon","LADU","350","31","14","22","1","418"
202021,"West Devon","LADU","377","19","16","23","2","437"
201516,"West Dorset","LADU","1227","79","35","41","5","1387"
201617,"West Dorset","LADU","1240","94","26","34","4","1398"
201718,"West Dorset","LADU","1163","70","39","51","8","1331"
201819,"West Dorset","LADU","1225","96","47","46","1","1415"
201516,"West Somerset","LADU","264","16","9","16","2","307"
201617,"West Somerset","LADU","187","9","10","6","0","212"
201718,"West Somerset","LADU","185","12","14","9","2","222"
201819,"West Somerset","LADU","159","8","9","11","2","189"
201516,"Weymouth and Portland","LADU","376","27","19","25","1","448"
201617,"Weymouth and Portland","LADU","382","20","18","21","3","444"
201718,"Weymouth and Portland","LADU","363","16","19","24","1","423"
201819,"Weymouth and Portland","LADU","322","17","20","16","2","377"
201516,"Wiltshire","LADU","4496","180","126","201","27","5030"
201617,"Wiltshire","LADU","4312","184","132","178","21","4827"
201718,"Wiltshire","LADU","4139","157","135","187","46","4664"
201819,"Wiltshire","LADU","4095","158","125","142","33","4553"
201920,"Wiltshire","LADU","4218","165","140","170","46","4739"
202021,"Wiltshire","LADU","4403","123","101","185","40","4852"
201516,"Black Country","LEP","10926","565","352","747","98","12688"
201617,"Black Country","LEP","10770","640","353","725","98","12586"
201718,"Black Country","LEP","10738","513","357","679","156","12443"
201819,"Black Country","LEP","10870","518","321","679","131","12519"
201920,"Black Country","LEP","11134","456","353","707","126","12776"
202021,"Black Country","LEP","11783","275","327","662","174","13221"
201516,"Buckinghamshire","LEP","5115","189","119","152","30","5605"
201617,"Buckinghamshire","LEP","5021","204","110","126","35","5496"
201718,"Buckinghamshire","LEP","5008","182","108","135","35","5468"
201819,"Buckinghamshire","LEP","5071","148","130","155","48","5552"
201920,"Buckinghamshire","LEP","5223","122","103","162","63","5673"
202021,"Buckinghamshire","LEP","5484","75","81","161","50","5851"
201516,"Cheshire and Warrington","LEP","8449","543","295","427","64","9778"
201617,"Cheshire and Warrington","LEP","8066","507","315","445","59","9392"
201718,"Cheshire and Warrington","LEP","7813","444","335","372","82","9046"
201819,"Cheshire and Warrington","LEP","7909","343","319","394","65","9030"
201920,"Cheshire and Warrington","LEP","8125","335","350","415","85","9310"
202021,"Cheshire and Warrington","LEP","8603","247","270","373","97","9590"
201516,"Coast to Capital","LEP","12434","474","356","575","105","13944"
201617,"Coast to Capital","LEP","12188","467","380","546","106","13687"
201718,"Coast to Capital","LEP","11727","477","380","501","127","13212"
201819,"Coast to Capital","LEP","11668","306","403","497","108","12982"
201920,"Coast to Capital","LEP","12110","360","417","561","134","13582"
202021,"Coast to Capital","LEP","12911","238","248","524","159","14080"
201516,"Cornwall and Isles of Scilly","LEP","4743","296","144","312","39","5534"
201617,"Cornwall and Isles of Scilly","LEP","4691","260","131","291","33","5406"
201718,"Cornwall and Isles of Scilly","LEP","4384","241","154","297","31","5107"
201819,"Cornwall and Isles of Scilly","LEP","4346","274","158","287","30","5095"
201920,"Cornwall and Isles of Scilly","LEP","4373","234","154","280","26","5067"
202021,"Cornwall and Isles of Scilly","LEP","4560","186","117","294","44","5201"
201516,"Coventry and Warwickshire","LEP","7778","476","254","430","54","8992"
201617,"Coventry and Warwickshire","LEP","7583","504","266","410","76","8839"
201718,"Coventry and Warwickshire","LEP","7530","378","294","396","63","8661"
201819,"Coventry and Warwickshire","LEP","7435","404","275","441","100","8655"
201920,"Coventry and Warwickshire","LEP","7728","358","297","437","111","8931"
202021,"Coventry and Warwickshire","LEP","8468","230","217","503","126","9544"
201516,"Cumbria","LEP","4278","543","190","237","27","5275"
201617,"Cumbria","LEP","4066","584","213","211","26","5100"
201718,"Cumbria","LEP","3921","526","205","191","20","4863"
201819,"Cumbria","LEP","3759","493","208","175","26","4661"
201920,"Cumbria","LEP","3962","455","224","222","30","4893"
202021,"Cumbria","LEP","4221","395","220","203","35","5074"
201516,"Derby, Derbyshire, Nottingham and Nottinghamshire","LEP","17922","1417","751","1249","151","21490"
201617,"Derby, Derbyshire, Nottingham and Nottinghamshire","LEP","16892","1439","767","1267","170","20535"
201718,"Derby, Derbyshire, Nottingham and Nottinghamshire","LEP","16356","1231","806","1177","143","19713"
201819,"Derby, Derbyshire, Nottingham and Nottinghamshire","LEP","16242","1227","828","1113","163","19573"
201920,"Derby, Derbyshire, Nottingham and Nottinghamshire","LEP","17078","1090","773","1146","177","20264"
202021,"Derby, Derbyshire, Nottingham and Nottinghamshire","LEP","18008","718","712","1252","211","20901"
201516,"Dorset","LEP","6254","416","214","313","39","7236"
201617,"Dorset","LEP","6072","412","246","296","40","7066"
201718,"Dorset","LEP","5925","329","252","251","39","6796"
201819,"Dorset","LEP","5764","358","270","248","38","6678"
201920,"Dorset","LEP","5989","313","269","307","52","6930"
202021,"Dorset","LEP","6257","221","172","283","70","7003"
201516,"Enterprise M3","LEP","12272","556","503","571","91","13993"
201617,"Enterprise M3","LEP","11854","514","473","488","80","13409"
201718,"Enterprise M3","LEP","11508","474","489","474","87","13032"
201819,"Enterprise M3","LEP","11358","421","430","513","89","12811"
201920,"Enterprise M3","LEP","11871","368","453","501","80","13273"
202021,"Enterprise M3","LEP","12462","290","290","473","141","13656"
201516,"Gloucestershire","LEP","5514","360","229","337","46","6486"
201617,"Gloucestershire","LEP","5409","330","219","274","50","6282"
201718,"Gloucestershire","LEP","5140","352","248","294","30","6064"
201819,"Gloucestershire","LEP","5034","310","284","255","31","5914"
201920,"Gloucestershire","LEP","5355","323","280","292","49","6299"
202021,"Gloucestershire","LEP","5573","191","191","237","52","6244"
201516,"Greater Birmingham and Solihull","LEP","19244","895","539","1093","200","21971"
201617,"Greater Birmingham and Solihull","LEP","18810","968","544","1030","240","21592"
201718,"Greater Birmingham and Solihull","LEP","18660","815","536","1121","240","21372"
201819,"Greater Birmingham and Solihull","LEP","18639","774","537","1040","257","21247"
201920,"Greater Birmingham and Solihull","LEP","19620","646","553","1136","288","22243"
202021,"Greater Birmingham and Solihull","LEP","21168","413","484","1208","397","23670"
201516,"Greater Cambridge and Greater Peterborough","LEP","6883","318","257","370","55","7883"
201617,"Greater Cambridge and Greater Peterborough","LEP","6828","319","266","350","66","7829"
201718,"Greater Cambridge and Greater Peterborough","LEP","6767","273","248","352","53","7693"
201819,"Greater Cambridge and Greater Peterborough","LEP","6591","293","276","386","73","7619"
201920,"Greater Cambridge and Greater Peterborough","LEP","6963","251","244","356","60","7874"
202021,"Greater Cambridge and Greater Peterborough","LEP","7358","157","200","360","95","8170"
201516,"Greater Lincolnshire","LEP","10456","628","248","605","63","12000"
201617,"Greater Lincolnshire","LEP","9977","653","270","552","61","11513"
201718,"Greater Lincolnshire","LEP","9746","566","263","495","74","11144"
201819,"Greater Lincolnshire","LEP","9319","568","291","468","67","10713"
201920,"Greater Lincolnshire","LEP","9789","561","316","484","77","11227"
202021,"Greater Lincolnshire","LEP","10350","343","273","534","112","11612"
201516,"Greater Manchester","LEP","23965","1485","957","1917","205","28529"
201617,"Greater Manchester","LEP","23559","1363","1044","1739","216","27921"
201718,"Greater Manchester","LEP","23238","1240","1060","1718","177","27433"
201819,"Greater Manchester","LEP","23781","1132","932","1624","210","27679"
201920,"Greater Manchester","LEP","24150","1104","1040","1859","258","28411"
202021,"Greater Manchester","LEP","26551","740","819","1703","303","30116"
201516,"Heart of South West","LEP","1227","90","37","76","4","1434"
201617,"Heart of South West","LEP","1125","76","51","49","5","1306"
201718,"Heart of South West","LEP","1054","63","65","50","9","1241"
201819,"Heart of South West","LEP","1011","73","50","79","8","1221"
201516,"Heart of the South West","LEP","13002","970","343","660","59","15034"
201617,"Heart of the South West","LEP","12656","924","400","589","69","14638"
201718,"Heart of the South West","LEP","11865","944","395","564","74","13842"
201819,"Heart of the South West","LEP","11500","926","425","591","71","13513"
201920,"Heart of the South West","LEP","13156","930","515","699","100","15400"
202021,"Heart of the South West","LEP","13739","788","398","717","101","15743"
201516,"Hertfordshire","LEP","11400","379","282","440","68","12569"
201617,"Hertfordshire","LEP","11210","390","320","402","63","12385"
201718,"Hertfordshire","LEP","11355","381","305","384","57","12482"
201819,"Hertfordshire","LEP","11156","265","306","368","78","12173"
201920,"Hertfordshire","LEP","11621","274","303","376","91","12665"
202021,"Hertfordshire","LEP","12130","161","196","391","88","12966"
201516,"Hull and East Yorkshire","LEP","4951","482","145","340","30","5948"
201617,"Hull and East Yorkshire","LEP","4548","480","169","297","36","5530"
201718,"Hull and East Yorkshire","LEP","4599","388","183","321","36","5527"
201819,"Hull and East Yorkshire","LEP","4530","375","182","265","31","5383"
201920,"Hull and East Yorkshire","LEP","4520","366","177","278","30","5371"
202021,"Hull and East Yorkshire","LEP","4953","278","186","325","50","5792"
201516,"Lancashire","LEP","13228","1019","520","942","105","15814"
201617,"Lancashire","LEP","12613","1130","511","826","101","15181"
201718,"Lancashire","LEP","12433","1056","533","857","94","14973"
201819,"Lancashire","LEP","12176","904","574","795","122","14571"
201920,"Lancashire","LEP","12627","882","607","830","136","15082"
202021,"Lancashire","LEP","13512","664","501","972","154","15803"
201516,"Leeds City Region","LEP","20674","1310","625","1506","245","24360"
201617,"Leeds City Region","LEP","20068","1258","682","1463","247","23718"
201718,"Leeds City Region","LEP","19681","1092","677","1455","261","23166"
201819,"Leeds City Region","LEP","19879","1180","719","1463","271","23512"
201920,"Leeds City Region","LEP","20561","1047","751","1407","257","24023"
202021,"Leeds City Region","LEP","22179","774","641","1503","395","25492"
201516,"Leicester and Leicestershire","LEP","8946","538","293","545","76","10398"
201617,"Leicester and Leicestershire","LEP","8768","481","313","590","80","10232"
201718,"Leicester and Leicestershire","LEP","8499","524","325","553","81","9982"
201819,"Leicester and Leicestershire","LEP","8711","462","350","529","93","10145"
201920,"Leicester and Leicestershire","LEP","9059","402","329","635","86","10511"
202021,"Leicester and Leicestershire","LEP","9810","262","266","595","155","11088"
201516,"Liverpool City Region","LEP","13275","789","470","972","79","15585"
201617,"Liverpool City Region","LEP","12718","682","517","983","111","15011"
201718,"Liverpool City Region","LEP","12275","614","587","908","90","14474"
201819,"Liverpool City Region","LEP","12013","580","566","910","108","14177"
201920,"Liverpool City Region","LEP","12609","545","498","968","107","14727"
202021,"Liverpool City Region","LEP","13318","394","417","976","144","15249"
201516,"London","LEP","67183","1614","1086","3353","914","74150"
201617,"London","LEP","68082","1535","1220","3341","963","75141"
201718,"London","LEP","67557","1202","1222","3143","940","74064"
201819,"London","LEP","68437","1068","1136","3053","982","74676"
201920,"London","LEP","71757","1022","1109","3125","1072","78085"
202021,"London","LEP","76130","545","687","2752","1352","81466"
201516,"New Anglia","LEP","13308","815","480","785","70","15458"
201617,"New Anglia","LEP","12855","821","493","729","44","14942"
201718,"New Anglia","LEP","12473","715","486","608","77","14359"
201819,"New Anglia","LEP","12205","687","425","629","74","14020"
201920,"New Anglia","LEP","12579","632","503","578","87","14379"
202021,"New Anglia","LEP","13515","428","388","705","98","15134"
201516,"North East","LEP","15807","1284","643","1228","83","19045"
201617,"North East","LEP","15224","1195","660","1091","111","18281"
201718,"North East","LEP","14558","1080","741","1220","124","17723"
201819,"North East","LEP","14557","988","629","1154","117","17445"
201920,"North East","LEP","14942","978","620","1219","111","17870"
202021,"North East","LEP","15865","615","627","1209","157","18473"
201516,"Oxfordshire","LEP","5235","366","225","247","35","6108"
201617,"Oxfordshire","LEP","5051","339","212","256","36","5894"
201718,"Oxfordshire","LEP","5078","262","208","251","60","5859"
201819,"Oxfordshire","LEP","4912","302","282","232","66","5794"
201920,"Oxfordshire","LEP","5185","313","248","265","54","6065"
202021,"Oxfordshire","LEP","5451","209","201","292","73","6226"
201516,"Sheffield City Region","LEP","11408","1041","500","858","72","13879"
201617,"Sheffield City Region","LEP","11092","885","536","848","85","13446"
201718,"Sheffield City Region","LEP","10672","782","594","821","85","12954"
201819,"Sheffield City Region","LEP","10608","763","557","780","109","12817"
201920,"Sheffield City Region","LEP","10928","712","535","915","86","13176"
202021,"Sheffield City Region","LEP","11697","462","549","950","163","13821"
201516,"Solent","LEP","9624","592","423","641","78","11358"
201617,"Solent","LEP","9141","591","463","654","106","10955"
201718,"Solent","LEP","9027","510","440","558","67","10602"
201819,"Solent","LEP","8653","481","411","616","74","10235"
201920,"Solent","LEP","8980","438","468","661","92","10639"
202021,"Solent","LEP","9683","307","317","578","99","10984"
201516,"South East","LEP","37294","1779","1228","2163","224","42688"
201617,"South East","LEP","35786","1706","1316","2033","265","41106"
201718,"South East","LEP","35306","1486","1376","1894","294","40356"
201819,"South East","LEP","34851","1436","1338","1949","306","39880"
201920,"South East","LEP","36121","1307","1316","2059","330","41133"
202021,"South East","LEP","38396","792","1039","1981","400","42608"
201516,"South East Midlands","LEP","15099","745","542","903","138","17427"
201617,"South East Midlands","LEP","14691","751","568","893","143","17046"
201718,"South East Midlands","LEP","14451","691","584","781","147","16654"
201819,"South East Midlands","LEP","14552","620","612","795","154","16733"
201920,"South East Midlands","LEP","15233","532","589","737","178","17269"
202021,"South East Midlands","LEP","16249","305","407","815","183","17959"
201516,"Stoke-on-Trent and Staffordshire","LEP","9520","684","394","479","24","11101"
201617,"Stoke-on-Trent and Staffordshire","LEP","9123","739","396","467","47","10772"
201718,"Stoke-on-Trent and Staffordshire","LEP","8795","675","346","463","74","10353"
201819,"Stoke-on-Trent and Staffordshire","LEP","8555","641","456","439","75","10166"
201920,"Stoke-on-Trent and Staffordshire","LEP","8880","570","482","575","66","10573"
202021,"Stoke-on-Trent and Staffordshire","LEP","9688","379","401","599","91","11158"
201516,"Swindon and Wiltshire","LEP","6369","264","188","268","38","7127"
201617,"Swindon and Wiltshire","LEP","6096","317","194","246","28","6881"
201718,"Swindon and Wiltshire","LEP","5882","232","195","264","65","6638"
201819,"Swindon and Wiltshire","LEP","5784","242","191","242","54","6513"
201920,"Swindon and Wiltshire","LEP","6021","233","212","248","75","6789"
202021,"Swindon and Wiltshire","LEP","6310","175","138","285","70","6978"
201516,"Tees Valley","LEP","6108","432","200","543","29","7312"
201617,"Tees Valley","LEP","5897","402","209","538","47","7093"
201718,"Tees Valley","LEP","5635","344","239","460","40","6718"
201819,"Tees Valley","LEP","5602","342","215","519","43","6721"
201920,"Tees Valley","LEP","5801","304","246","509","34","6894"
202021,"Tees Valley","LEP","6174","204","220","512","53","7163"
201516,"Thames Valley Berkshire","LEP","8014","307","204","261","58","8844"
201617,"Thames Valley Berkshire","LEP","7795","340","212","306","75","8728"
201718,"Thames Valley Berkshire","LEP","7842","284","264","270","78","8738"
201819,"Thames Valley Berkshire","LEP","7655","254","241","303","74","8527"
201920,"Thames Valley Berkshire","LEP","8154","247","257","314","81","9053"
202021,"Thames Valley Berkshire","LEP","8780","142","183","317","90","9512"
201516,"The Marches","LEP","5791","362","266","331","55","6805"
201617,"The Marches","LEP","5653","341","255","313","52","6614"
201718,"The Marches","LEP","5365","297","211","318","45","6236"
201819,"The Marches","LEP","5358","307","255","294","65","6279"
201920,"The Marches","LEP","5451","301","263","338","98","6451"
202021,"The Marches","LEP","5792","204","190","330","93","6609"
201516,"West of England","LEP","8656","580","283","516","69","10104"
201617,"West of England","LEP","8355","587","376","501","77","9896"
201718,"West of England","LEP","8278","527","365","469","89","9728"
201819,"West of England","LEP","8236","495","345","440","65","9581"
201920,"West of England","LEP","8603","492","320","483","111","10009"
202021,"West of England","LEP","9078","334","234","461","79","10186"
201516,"Worcestershire","LEP","4842","291","208","212","30","5583"
201617,"Worcestershire","LEP","4734","299","177","226","31","5467"
201718,"Worcestershire","LEP","4541","272","197","204","32","5246"
201819,"Worcestershire","LEP","4465","269","189","193","27","5143"
201920,"Worcestershire","LEP","4616","229","198","243","50","5336"
202021,"Worcestershire","LEP","4915","152","183","247","30","5527"
201516,"York and North Yorkshire","LEP","7020","477","238","291","37","8063"
201617,"York and North Yorkshire","LEP","6696","447","208","274","49","7674"
201718,"York and North Yorkshire","LEP","6446","418","242","286","36","7428"
201819,"York and North Yorkshire","LEP","6439","422","283","289","54","7487"
201920,"York and North Yorkshire","LEP","6655","363","329","341","48","7736"
202021,"York and North Yorkshire","LEP","6908","329","263","256","58","7814"
201516,"Brighton and Hove, East Sussex, West Sussex","LSIP","13463","526","401","750","101","15241"
201617,"Brighton and Hove, East Sussex, West Sussex","LSIP","13106","516","432","716","103","14873"
201718,"Brighton and Hove, East Sussex, West Sussex","LSIP","12734","500","442","693","113","14482"
201819,"Brighton and Hove, East Sussex, West Sussex","LSIP","12543","358","463","639","101","14104"
201920,"Brighton and Hove, East Sussex, West Sussex","LSIP","12948","396","464","751","136","14695"
202021,"Brighton and Hove, East Sussex, West Sussex","LSIP","13629","258","297","672","140","14996"
201516,"Buckinghamshire","LSIP","5115","189","119","152","30","5605"
201617,"Buckinghamshire","LSIP","5021","204","110","126","35","5496"
201718,"Buckinghamshire","LSIP","5008","182","108","135","35","5468"
201819,"Buckinghamshire","LSIP","5071","148","130","155","48","5552"
201920,"Buckinghamshire","LSIP","5223","122","103","162","63","5673"
202021,"Buckinghamshire","LSIP","5484","75","81","161","50","5851"
201516,"Cambridgeshire and Peterborough","LSIP","6883","318","257","370","55","7883"
201617,"Cambridgeshire and Peterborough","LSIP","6828","319","266","350","66","7829"
201718,"Cambridgeshire and Peterborough","LSIP","6767","273","248","352","53","7693"
201819,"Cambridgeshire and Peterborough","LSIP","6591","293","276","386","73","7619"
201920,"Cambridgeshire and Peterborough","LSIP","6963","251","244","356","60","7874"
202021,"Cambridgeshire and Peterborough","LSIP","7358","157","200","360","95","8170"
201516,"Cheshire and Warrington","LSIP","8449","543","295","427","64","9778"
201617,"Cheshire and Warrington","LSIP","8066","507","315","445","59","9392"
201718,"Cheshire and Warrington","LSIP","7813","444","335","372","82","9046"
201819,"Cheshire and Warrington","LSIP","7909","343","319","394","65","9030"
201920,"Cheshire and Warrington","LSIP","8125","335","350","415","85","9310"
202021,"Cheshire and Warrington","LSIP","8603","247","270","373","97","9590"
201516,"Cornwall and the Isles of Scilly","LSIP","4743","296","144","312","39","5534"
201617,"Cornwall and the Isles of Scilly","LSIP","4691","260","131","291","33","5406"
201718,"Cornwall and the Isles of Scilly","LSIP","4384","241","154","297","31","5107"
201819,"Cornwall and the Isles of Scilly","LSIP","4346","274","158","287","30","5095"
201920,"Cornwall and the Isles of Scilly","LSIP","4373","234","154","280","26","5067"
202021,"Cornwall and the Isles of Scilly","LSIP","4560","186","117","294","44","5201"
201516,"Cumbria","LSIP","4278","543","190","237","27","5275"
201617,"Cumbria","LSIP","4066","584","213","211","26","5100"
201718,"Cumbria","LSIP","3921","526","205","191","20","4863"
201819,"Cumbria","LSIP","3759","493","208","175","26","4661"
201920,"Cumbria","LSIP","3962","455","224","222","30","4893"
202021,"Cumbria","LSIP","4221","395","220","203","35","5074"
201516,"Derbyshire and Nottinghamshire","LSIP","17922","1417","751","1249","151","21490"
201617,"Derbyshire and Nottinghamshire","LSIP","16892","1439","767","1267","170","20535"
201718,"Derbyshire and Nottinghamshire","LSIP","16356","1231","806","1177","143","19713"
201819,"Derbyshire and Nottinghamshire","LSIP","16242","1227","828","1113","163","19573"
201920,"Derbyshire and Nottinghamshire","LSIP","17078","1090","773","1146","177","20264"
202021,"Derbyshire and Nottinghamshire","LSIP","18008","718","712","1252","211","20901"
201516,"Dorset","LSIP","12427","727","468","588","77","14287"
201617,"Dorset","LSIP","11991","712","472","533","78","13786"
201718,"Dorset","LSIP","11598","583","505","490","67","13243"
201819,"Dorset","LSIP","11465","604","500","510","76","13155"
201920,"Dorset","LSIP","11726","531","515","597","84","13453"
202021,"Dorset","LSIP","12373","380","332","545","119","13749"
201516,"Enterprise M3 LEP (including all of Surrey)","LSIP","9498","392","322","419","80","10711"
201617,"Enterprise M3 LEP (including all of Surrey)","LSIP","9210","343","342","371","65","10331"
201718,"Enterprise M3 LEP (including all of Surrey)","LSIP","8911","345","329","343","97","10025"
201819,"Enterprise M3 LEP (including all of Surrey)","LSIP","8774","256","292","376","84","9782"
201920,"Enterprise M3 LEP (including all of Surrey)","LSIP","9333","256","304","335","82","10310"
202021,"Enterprise M3 LEP (including all of Surrey)","LSIP","9850","201","180","318","142","10691"
201516,"Essex, Southend-on-Sea and Thurrock","LSIP","16357","878","597","860","104","18796"
201617,"Essex, Southend-on-Sea and Thurrock","LSIP","15621","830","657","847","101","18056"
201718,"Essex, Southend-on-Sea and Thurrock","LSIP","15552","725","608","810","119","17814"
201819,"Essex, Southend-on-Sea and Thurrock","LSIP","15099","716","580","838","102","17335"
201920,"Essex, Southend-on-Sea and Thurrock","LSIP","15798","636","589","844","128","17995"
202021,"Essex, Southend-on-Sea and Thurrock","LSIP","17021","358","474","925","166","18944"
201516,"Gloucestershire","LSIP","5514","360","229","337","46","6486"
201617,"Gloucestershire","LSIP","5409","330","219","274","50","6282"
201718,"Gloucestershire","LSIP","5140","352","248","294","30","6064"
201819,"Gloucestershire","LSIP","5034","310","284","255","31","5914"
201920,"Gloucestershire","LSIP","5355","323","280","292","49","6299"
202021,"Gloucestershire","LSIP","5573","191","191","237","52","6244"
201516,"Greater Lincolnshire","LSIP","10456","628","248","605","63","12000"
201617,"Greater Lincolnshire","LSIP","9977","653","270","552","61","11513"
201718,"Greater Lincolnshire","LSIP","9746","566","263","495","74","11144"
201819,"Greater Lincolnshire","LSIP","9319","568","291","468","67","10713"
201920,"Greater Lincolnshire","LSIP","9789","561","316","484","77","11227"
202021,"Greater Lincolnshire","LSIP","10350","343","273","534","112","11612"
201516,"Greater London","LSIP","67183","1614","1086","3353","914","74150"
201617,"Greater London","LSIP","68082","1535","1220","3341","963","75141"
201718,"Greater London","LSIP","67557","1202","1222","3143","940","74064"
201819,"Greater London","LSIP","68437","1068","1136","3053","982","74676"
201920,"Greater London","LSIP","71757","1022","1109","3125","1072","78085"
202021,"Greater London","LSIP","76130","545","687","2752","1352","81466"
201516,"Greater Manchester","LSIP","23965","1485","957","1917","205","28529"
201617,"Greater Manchester","LSIP","23559","1363","1044","1739","216","27921"
201718,"Greater Manchester","LSIP","23238","1240","1060","1718","177","27433"
201819,"Greater Manchester","LSIP","23781","1132","932","1624","210","27679"
201920,"Greater Manchester","LSIP","24150","1104","1040","1859","258","28411"
202021,"Greater Manchester","LSIP","26551","740","819","1703","303","30116"
201516,"Heart of the South-West","LSIP","14229","1060","380","736","63","16468"
201617,"Heart of the South-West","LSIP","13781","1000","451","638","74","15944"
201718,"Heart of the South-West","LSIP","12919","1007","460","614","83","15083"
201819,"Heart of the South-West","LSIP","12511","999","475","670","79","14734"
201920,"Heart of the South-West","LSIP","13156","930","515","699","100","15400"
202021,"Heart of the South-West","LSIP","13739","788","398","717","101","15743"
201516,"Hertfordshire","LSIP","11400","379","282","440","68","12569"
201617,"Hertfordshire","LSIP","11210","390","320","402","63","12385"
201718,"Hertfordshire","LSIP","11355","381","305","384","57","12482"
201819,"Hertfordshire","LSIP","11156","265","306","368","78","12173"
201920,"Hertfordshire","LSIP","11621","274","303","376","91","12665"
202021,"Hertfordshire","LSIP","12130","161","196","391","88","12966"
201516,"Hull and East Yorkshire","LSIP","4951","482","145","340","30","5948"
201617,"Hull and East Yorkshire","LSIP","4548","480","169","297","36","5530"
201718,"Hull and East Yorkshire","LSIP","4599","388","183","321","36","5527"
201819,"Hull and East Yorkshire","LSIP","4530","375","182","265","31","5383"
201920,"Hull and East Yorkshire","LSIP","4520","366","177","278","30","5371"
202021,"Hull and East Yorkshire","LSIP","4953","278","186","325","50","5792"
201516,"Kent and Medway","LSIP","16509","702","513","1005","97","18826"
201617,"Kent and Medway","LSIP","15972","698","512","896","144","18222"
201718,"Kent and Medway","LSIP","15671","613","613","784","151","17832"
201819,"Kent and Medway","LSIP","15760","587","606","844","178","17975"
201920,"Kent and Medway","LSIP","16286","529","583","901","166","18465"
202021,"Kent and Medway","LSIP","17153","344","466","801","203","18967"
201516,"Lancashire","LSIP","13228","1019","520","942","105","15814"
201617,"Lancashire","LSIP","12613","1130","511","826","101","15181"
201718,"Lancashire","LSIP","12433","1056","533","857","94","14973"
201819,"Lancashire","LSIP","12176","904","574","795","122","14571"
201920,"Lancashire","LSIP","12627","882","607","830","136","15082"
202021,"Lancashire","LSIP","13512","664","501","972","154","15803"
201516,"Leicester and Leicestershire","LSIP","8946","538","293","545","76","10398"
201617,"Leicester and Leicestershire","LSIP","8768","481","313","590","80","10232"
201718,"Leicester and Leicestershire","LSIP","8499","524","325","553","81","9982"
201819,"Leicester and Leicestershire","LSIP","8711","462","350","529","93","10145"
201920,"Leicester and Leicestershire","LSIP","9059","402","329","635","86","10511"
202021,"Leicester and Leicestershire","LSIP","9810","262","266","595","155","11088"
201516,"Liverpool City Region","LSIP","13275","789","470","972","79","15585"
201617,"Liverpool City Region","LSIP","12718","682","517","983","111","15011"
201718,"Liverpool City Region","LSIP","12275","614","587","908","90","14474"
201819,"Liverpool City Region","LSIP","12013","580","566","910","108","14177"
201920,"Liverpool City Region","LSIP","12609","545","498","968","107","14727"
202021,"Liverpool City Region","LSIP","13318","394","417","976","144","15249"
201516,"Norfolk and Suffolk","LSIP","9960","646","371","596","55","11628"
201617,"Norfolk and Suffolk","LSIP","9631","605","372","561","37","11206"
201718,"Norfolk and Suffolk","LSIP","9310","542","357","477","61","10747"
201819,"Norfolk and Suffolk","LSIP","9097","515","316","478","55","10461"
201920,"Norfolk and Suffolk","LSIP","12579","632","503","578","87","14379"
202021,"Norfolk and Suffolk","LSIP","13515","428","388","705","98","15134"
201516,"Norfolk and Suffolk (Greater Anglia)","LSIP","3348","169","109","189","15","3830"
201617,"Norfolk and Suffolk (Greater Anglia)","LSIP","3224","216","121","168","7","3736"
201718,"Norfolk and Suffolk (Greater Anglia)","LSIP","3163","173","129","131","16","3612"
201819,"Norfolk and Suffolk (Greater Anglia)","LSIP","3108","172","109","151","19","3559"
201516,"North East","LSIP","9356","805","386","776","37","11360"
201617,"North East","LSIP","9118","757","354","629","59","10917"
201718,"North East","LSIP","8546","668","425","737","66","10442"
201819,"North East","LSIP","8508","640","341","685","63","10237"
201920,"North East","LSIP","8917","585","343","724","68","10637"
202021,"North East","LSIP","9424","392","378","779","73","11046"
201516,"North of Tyne","LSIP","6451","479","257","452","46","7685"
201617,"North of Tyne","LSIP","6106","438","306","462","52","7364"
201718,"North of Tyne","LSIP","6012","412","316","483","58","7281"
201819,"North of Tyne","LSIP","6049","348","288","469","54","7208"
201920,"North of Tyne","LSIP","6025","393","277","495","43","7233"
202021,"North of Tyne","LSIP","6441","223","249","430","84","7427"
201516,"Oxfordshire","LSIP","5235","366","225","247","35","6108"
201617,"Oxfordshire","LSIP","5051","339","212","256","36","5894"
201718,"Oxfordshire","LSIP","5078","262","208","251","60","5859"
201819,"Oxfordshire","LSIP","4912","302","282","232","66","5794"
201920,"Oxfordshire","LSIP","5185","313","248","265","54","6065"
202021,"Oxfordshire","LSIP","5451","209","201","292","73","6226"
201516,"Solent","LSIP","9624","592","423","641","78","11358"
201617,"Solent","LSIP","9141","591","463","654","106","10955"
201718,"Solent","LSIP","9027","510","440","558","67","10602"
201819,"Solent","LSIP","8653","481","411","616","74","10235"
201920,"Solent","LSIP","8980","438","468","661","92","10639"
202021,"Solent","LSIP","9683","307","317","578","99","10984"
201516,"South East Midlands","LSIP","15099","745","542","903","138","17427"
201617,"South East Midlands","LSIP","14691","751","568","893","143","17046"
201718,"South East Midlands","LSIP","14451","691","584","781","147","16654"
201819,"South East Midlands","LSIP","14552","620","612","795","154","16733"
201920,"South East Midlands","LSIP","15233","532","589","737","178","17269"
202021,"South East Midlands","LSIP","16249","305","407","815","183","17959"
201516,"South Yorkshire","LSIP","11408","1041","500","858","72","13879"
201617,"South Yorkshire","LSIP","11092","885","536","848","85","13446"
201718,"South Yorkshire","LSIP","10672","782","594","821","85","12954"
201819,"South Yorkshire","LSIP","10608","763","557","780","109","12817"
201920,"South Yorkshire","LSIP","10928","712","535","915","86","13176"
202021,"South Yorkshire","LSIP","11697","462","549","950","163","13821"
201516,"Stoke-on-Trent and Staffordshire","LSIP","9520","684","394","479","24","11101"
201617,"Stoke-on-Trent and Staffordshire","LSIP","9123","739","396","467","47","10772"
201718,"Stoke-on-Trent and Staffordshire","LSIP","8795","675","346","463","74","10353"
201819,"Stoke-on-Trent and Staffordshire","LSIP","8555","641","456","439","75","10166"
201920,"Stoke-on-Trent and Staffordshire","LSIP","8880","570","482","575","66","10573"
202021,"Stoke-on-Trent and Staffordshire","LSIP","9688","379","401","599","91","11158"
201516,"Swindon and Wiltshire","LSIP","6369","264","188","268","38","7127"
201617,"Swindon and Wiltshire","LSIP","6096","317","194","246","28","6881"
201718,"Swindon and Wiltshire","LSIP","5882","232","195","264","65","6638"
201819,"Swindon and Wiltshire","LSIP","5784","242","191","242","54","6513"
201920,"Swindon and Wiltshire","LSIP","6021","233","212","248","75","6789"
202021,"Swindon and Wiltshire","LSIP","6310","175","138","285","70","6978"
201516,"Tees Valley","LSIP","6108","432","200","543","29","7312"
201617,"Tees Valley","LSIP","5897","402","209","538","47","7093"
201718,"Tees Valley","LSIP","5635","344","239","460","40","6718"
201819,"Tees Valley","LSIP","5602","342","215","519","43","6721"
201920,"Tees Valley","LSIP","5801","304","246","509","34","6894"
202021,"Tees Valley","LSIP","6174","204","220","512","53","7163"
201516,"Thames Valley Berkshire","LSIP","8014","307","204","261","58","8844"
201617,"Thames Valley Berkshire","LSIP","7795","340","212","306","75","8728"
201718,"Thames Valley Berkshire","LSIP","7842","284","264","270","78","8738"
201819,"Thames Valley Berkshire","LSIP","7655","254","241","303","74","8527"
201920,"Thames Valley Berkshire","LSIP","8154","247","257","314","81","9053"
202021,"Thames Valley Berkshire","LSIP","8780","142","183","317","90","9512"
201516,"The Marches","LSIP","5791","362","266","331","55","6805"
201617,"The Marches","LSIP","5653","341","255","313","52","6614"
201718,"The Marches","LSIP","5365","297","211","318","45","6236"
201819,"The Marches","LSIP","5358","307","255","294","65","6279"
201920,"The Marches","LSIP","5451","301","263","338","98","6451"
202021,"The Marches","LSIP","5792","204","190","330","93","6609"
201516,"West Midlands and Warwickshire","LSIP","31877","1532","899","2014","329","36651"
201617,"West Midlands and Warwickshire","LSIP","31210","1664","940","1897","382","36093"
201718,"West Midlands and Warwickshire","LSIP","31174","1311","974","1927","411","35797"
201819,"West Midlands and Warwickshire","LSIP","31352","1286","900","1930","445","35913"
201920,"West Midlands and Warwickshire","LSIP","32772","1123","943","1989","481","37308"
202021,"West Midlands and Warwickshire","LSIP","35154","709","791","2093","638","39385"
201516,"West of England and North Somerset","LSIP","8656","580","283","516","69","10104"
201617,"West of England and North Somerset","LSIP","8355","587","376","501","77","9896"
201718,"West of England and North Somerset","LSIP","8278","527","365","469","89","9728"
201819,"West of England and North Somerset","LSIP","8236","495","345","440","65","9581"
201920,"West of England and North Somerset","LSIP","8603","492","320","483","111","10009"
202021,"West of England and North Somerset","LSIP","9078","334","234","461","79","10186"
201516,"West Yorkshire","LSIP","20674","1310","625","1506","245","24360"
201617,"West Yorkshire","LSIP","20068","1258","682","1463","247","23718"
201718,"West Yorkshire","LSIP","19681","1092","677","1455","261","23166"
201819,"West Yorkshire","LSIP","19879","1180","719","1463","271","23512"
201920,"West Yorkshire","LSIP","20561","1047","751","1407","257","24023"
202021,"West Yorkshire","LSIP","22179","774","641","1503","395","25492"
201516,"Worcestershire","LSIP","4842","291","208","212","30","5583"
201617,"Worcestershire","LSIP","4734","299","177","226","31","5467"
201718,"Worcestershire","LSIP","4541","272","197","204","32","5246"
201819,"Worcestershire","LSIP","4465","269","189","193","27","5143"
201920,"Worcestershire","LSIP","4616","229","198","243","50","5336"
202021,"Worcestershire","LSIP","4915","152","183","247","30","5527"
201516,"York and North Yorkshire","LSIP","7020","477","238","291","37","8063"
201617,"York and North Yorkshire","LSIP","6696","447","208","274","49","7674"
201718,"York and North Yorkshire","LSIP","6446","418","242","286","36","7428"
201819,"York and North Yorkshire","LSIP","6439","422","283","289","54","7487"
201920,"York and North Yorkshire","LSIP","6655","363","329","341","48","7736"
202021,"York and North Yorkshire","LSIP","6908","329","263","256","58","7814"
201516,"Cambridgeshire and Peterborough","MCA","6883","318","257","370","55","7883"
201617,"Cambridgeshire and Peterborough","MCA","6828","319","266","350","66","7829"
201718,"Cambridgeshire and Peterborough","MCA","6767","273","248","352","53","7693"
201819,"Cambridgeshire and Peterborough","MCA","6591","293","276","386","73","7619"
201920,"Cambridgeshire and Peterborough","MCA","6963","251","244","356","60","7874"
202021,"Cambridgeshire and Peterborough","MCA","7358","157","200","360","95","8170"
201516,"Greater Manchester","MCA","23965","1485","957","1917","205","28529"
201617,"Greater Manchester","MCA","23559","1363","1044","1739","216","27921"
201718,"Greater Manchester","MCA","23238","1240","1060","1718","177","27433"
201819,"Greater Manchester","MCA","23781","1132","932","1624","210","27679"
201920,"Greater Manchester","MCA","24150","1104","1040","1859","258","28411"
202021,"Greater Manchester","MCA","26551","740","819","1703","303","30116"
201516,"Liverpool City Region","MCA","13275","789","470","972","79","15585"
201617,"Liverpool City Region","MCA","12718","682","517","983","111","15011"
201718,"Liverpool City Region","MCA","12275","614","587","908","90","14474"
201819,"Liverpool City Region","MCA","12013","580","566","910","108","14177"
201920,"Liverpool City Region","MCA","12609","545","498","968","107","14727"
202021,"Liverpool City Region","MCA","13318","394","417","976","144","15249"
201516,"North East","MCA","9356","805","386","776","37","11360"
201617,"North East","MCA","9118","757","354","629","59","10917"
201718,"North East","MCA","8546","668","425","737","66","10442"
201819,"North East","MCA","8508","640","341","685","63","10237"
201920,"North East","MCA","8917","585","343","724","68","10637"
202021,"North East","MCA","9424","392","378","779","73","11046"
201516,"North of Tyne","MCA","6451","479","257","452","46","7685"
201617,"North of Tyne","MCA","6106","438","306","462","52","7364"
201718,"North of Tyne","MCA","6012","412","316","483","58","7281"
201819,"North of Tyne","MCA","6049","348","288","469","54","7208"
201920,"North of Tyne","MCA","6025","393","277","495","43","7233"
202021,"North of Tyne","MCA","6441","223","249","430","84","7427"
201516,"South Yorkshire","MCA","11408","1041","500","858","72","13879"
201617,"South Yorkshire","MCA","11092","885","536","848","85","13446"
201718,"South Yorkshire","MCA","10672","782","594","821","85","12954"
201819,"South Yorkshire","MCA","10608","763","557","780","109","12817"
201920,"South Yorkshire","MCA","10928","712","535","915","86","13176"
202021,"South Yorkshire","MCA","11697","462","549","950","163","13821"
201516,"Tees Valley","MCA","6108","432","200","543","29","7312"
201617,"Tees Valley","MCA","5897","402","209","538","47","7093"
201718,"Tees Valley","MCA","5635","344","239","460","40","6718"
201819,"Tees Valley","MCA","5602","342","215","519","43","6721"
201920,"Tees Valley","MCA","5801","304","246","509","34","6894"
202021,"Tees Valley","MCA","6174","204","220","512","53","7163"
201516,"West Midlands","MCA","26890","1242","744","1785","306","30967"
201617,"West Midlands","MCA","26468","1391","764","1652","347","30622"
201718,"West Midlands","MCA","26449","1071","796","1720","384","30420"
201819,"West Midlands","MCA","26674","1036","723","1721","406","30560"
201920,"West Midlands","MCA","27929","907","765","1759","435","31795"
202021,"West Midlands","MCA","29914","560","642","1830","578","33524"
201516,"West of England","MCA","6717","479","228","427","62","7913"
201617,"West of England","MCA","6481","494","306","405","66","7752"
201718,"West of England","MCA","6447","427","322","391","81","7668"
201819,"West of England","MCA","6407","400","295","376","53","7531"
201920,"West of England","MCA","6745","412","266","399","95","7917"
202021,"West of England","MCA","7081","278","194","399","67","8019"
201516,"West Yorkshire","MCA","20674","1310","625","1506","245","24360"
201617,"West Yorkshire","MCA","20068","1258","682","1463","247","23718"
201718,"West Yorkshire","MCA","19681","1092","677","1455","261","23166"
201819,"West Yorkshire","MCA","19879","1180","719","1463","271","23512"
201920,"West Yorkshire","MCA","20561","1047","751","1407","257","24023"
202021,"West Yorkshire","MCA","22179","774","641","1503","395","25492"
201516,"Greater London Authority","MCA","67183","1614","1086","3353","914","74150"
201617,"Greater London Authority","MCA","68082","1535","1220","3341","963","75141"
201718,"Greater London Authority","MCA","67557","1202","1222","3143","940","74064"
201819,"Greater London Authority","MCA","68437","1068","1136","3053","982","74676"
201920,"Greater London Authority","MCA","71757","1022","1109","3125","1072","78085"
202021,"Greater London Authority","MCA","76130","545","687","2752","1352","81466"
